product,own_files_count,own_files_loc,own_functions_count,own_functions_loc,total_dependency_functions_count,total_dependency_functions_loc,total_dependency_files_count,total_dependency_files_loc,reachable_dependencies,reachable_dependencies_loc,reachable_dependency_files,reachable_dependency_files_loc,reachable_dependency_functions,reachable_dependency_functions_loc,total_dependencies_count,total_dependencies_loc,bloated_dependencies_count,bloated_dependencies_loc,bloated_files_count,bloated_files_loc,bloated_functions_count,bloated_functions_loc,vulnerable_dependencies_reachable,vulnerable_dependencies_bloated,vulnerable_dependencies_reachable_through_functions,vulnerable_dependencies_bloated_through_functions,vulnerable_dependencies_unresolved_through_functions
mozillasecurity/grizzly,185,46882,1816,35022,5198,79100,340,112283,14,86634,85,39912,586,12266,20,20,6,25649,255,72371,4618,66834,1,1,0,1,0
mozillasecurity/funfuzz,38,6226,191,4919,5999,111362,459,150249,4,134062,15,11124,39,1142,7,7,3,16187,444,139125,5960,110220,0,1,0,0,0
buckket/twtxt,13,1551,102,942,2755,45710,136,64431,9,59449,30,25217,175,4214,13,13,4,4982,106,39214,2585,41496,1,0,0,1,0
foremast/foremast,159,13854,372,8712,19357,239585,1460,407204,19,179542,76,39270,444,8690,47,47,28,227662,1384,367934,18913,230895,0,2,0,0,0
onecodex/onecodex,49,9990,387,7775,6744,100335,631,193017,12,170493,54,32521,305,6320,22,22,10,22524,577,160496,6441,94015,0,1,0,0,0
certbot/certbot,227,43042,1902,29433,5849,83618,307,123927,11,82067,56,32533,358,6130,19,19,8,41860,251,91394,5524,77488,2,1,0,2,0
slaclab/pydm,113,32462,1563,21650,17124,386387,1188,530651,8,493874,88,75564,735,19758,14,14,6,36777,1100,455087,16389,366629,0,1,0,0,0
dropbox/dropbox-sdk-python,39,156142,9634,73732,19103,256495,1387,489046,4,35311,13,7520,56,1016,51,51,47,453735,1374,481526,19054,255479,0,2,0,0,0
python-amazon-mws/python-amazon-mws,35,5890,240,3839,882,22187,73,32714,2,16611,10,4619,17,339,5,5,3,16103,63,28095,866,21848,0,1,0,0,0
opendatacube/datacube-core,166,42368,2582,31089,38885,701134,1794,958525,32,912322,399,441636,2855,87726,54,54,22,46203,1395,516889,36089,613408,0,1,0,0,0
opendatacube/eo-datasets,32,14812,479,10432,53651,987391,2695,1357157,27,986633,260,256808,1666,52352,68,68,41,370524,2435,1100349,52028,935039,0,1,0,0,0
opendatacube/datacube-explorer,56,18190,632,12448,59606,1084334,3061,1511618,33,789911,352,361499,2210,61887,86,86,53,721707,2709,1150119,57459,1022447,0,1,0,0,0
pydanny/cached-property,3,237,15,88,9712,123458,389,185302,1,27538,1,242,3,21,12,12,11,157764,388,185060,9709,123437,0,1,0,0,0
pydanny/cookiecutter-django,28,1559,81,874,18148,247817,1233,404729,6,106218,24,15264,89,1779,69,69,63,298511,1209,389465,18060,246038,0,2,0,0,0
cedadev/cf-checker,3,3580,91,3298,4060,103943,262,142143,2,136793,12,30196,50,2237,6,6,4,5350,250,111947,4010,101706,0,1,0,0,0
cedadev/cis,69,17714,949,14258,31256,657514,1851,966504,15,787308,163,211050,1164,41109,37,37,22,179196,1688,755454,30100,616405,0,1,0,0,0
dbt-labs/dbt,199,52533,3473,31542,14119,255251,1114,348934,26,267143,126,55574,379,8732,45,45,19,81791,988,293360,13773,246519,0,1,0,0,0
python-visualization/folium,41,8083,165,3170,5534,131916,344,182924,5,166454,31,39095,117,3943,9,9,4,16470,313,143829,5418,127973,0,1,0,0,0
instaloader/instaloader,11,5395,350,4248,882,22187,73,32714,3,27987,20,7737,120,2630,5,5,2,4727,53,24977,762,19557,0,1,0,0,0
googleapis/google-api-python-client,73,12793,335,8223,4307,69972,509,137257,4,14620,10,4212,46,1036,18,18,14,122637,499,133045,4261,68936,0,1,0,0,0
opentok/opentok-python-sdk,16,3387,121,2594,2780,44884,171,69441,7,50618,38,23908,156,2845,11,11,4,18823,133,45533,2626,42039,0,1,0,0,0
newrelic/newrelic-python-agent,285,60545,2920,40360,1380,28194,99,41181,2,12374,3,1452,22,374,8,8,6,28807,96,39729,1358,27820,0,1,0,0,0
aamalev/aiohttp_apiset,17,3314,300,2439,2530,39367,143,56404,7,39996,19,12218,37,941,14,14,7,16408,124,44186,2502,38426,1,0,0,1,0
anaconda-platform/anaconda-client,66,8525,423,5988,1750,35279,130,52208,6,33469,27,13082,77,1730,10,10,4,18739,103,39126,1673,33549,0,1,0,0,0
syncplay/syncplay,61,24193,1206,12121,16126,189802,872,313155,10,233867,116,85116,602,9084,20,20,10,79288,756,228039,15528,180718,1,0,0,1,1
aschn/drf-tracking,19,677,24,211,17392,223637,1598,362780,4,181622,27,19539,104,1786,40,40,36,181158,1571,343241,17292,221851,0,1,0,0,0
pygithub/pygithub,136,32811,2225,22354,3856,54433,228,80581,7,39095,28,11141,102,2129,12,12,5,41486,200,69440,3755,52304,0,2,0,0,0
django-es/django-elasticsearch-dsl,27,1974,82,953,2204,39446,180,58753,3,39361,14,8462,46,871,6,6,3,19392,166,50291,2159,38575,0,1,0,0,0
sabnzbd/sabnzbd,72,40095,1504,28675,8601,103012,528,190936,14,128239,129,49259,363,7768,29,29,15,62697,399,141677,8240,95244,2,0,0,2,0
ctpug/wafer,150,7970,352,3219,19972,265385,1685,391412,22,272053,199,94295,960,17847,41,41,19,119359,1486,297117,19050,247538,0,1,0,0,0
bear/python-twitter,11,1831,59,655,3182,55519,381,86232,6,81505,38,21987,235,4640,8,8,2,4727,343,64245,2949,50879,0,1,0,0,0
a10networks/acos-client,98,8046,611,4305,987,22972,79,34221,4,18118,12,5784,30,489,7,7,3,16103,67,28437,957,22483,0,1,0,0,0
coala/coala,195,22827,804,15637,3825,61159,516,188930,12,168886,57,23302,191,3762,17,17,5,20044,459,165628,3637,57397,0,1,0,0,0
sorgerlab/indra,304,70280,2791,54135,45972,908577,3416,1521833,20,1164484,166,144795,896,32010,51,51,31,357349,3250,1377038,45084,876567,0,1,0,0,0
stencila/hub,282,30681,1067,16633,16747,291815,1142,401755,5,61672,30,14054,150,3317,38,38,33,340083,1112,387701,16597,288498,0,2,0,0,0
globus/globus-cli,227,18475,642,10604,5085,73327,401,111089,7,70601,73,33413,297,6375,14,14,7,40488,328,77676,4798,66952,1,1,0,1,0
globus/globus-sdk-python,184,21739,617,12619,3638,50124,191,74738,6,50891,28,15204,146,3013,10,10,4,23847,163,59534,3492,47111,1,1,0,1,0
micropyramid/django-mfa,29,1375,59,625,13220,161349,1095,318165,3,152381,102,43701,382,6490,18,18,15,165784,993,274464,12846,154859,0,1,0,0,0
micropyramid/forex-python,4,411,25,274,945,23773,82,34758,3,18655,12,5509,23,539,6,6,3,16103,70,29249,922,23234,0,1,0,0,0
sethblack/python-seo-analyzer,9,957,31,625,2491,45088,145,65369,6,50965,26,15279,134,3800,10,10,4,14404,119,50090,2357,41288,0,0,0,0,1
opennetworkingfoundation/tapi,0,0,0,0,1156,27163,82,39921,0,0,0,0,0,0,9,9,9,39921,82,39921,1156,27163,0,1,0,0,0
polyaxon/polyaxon,0,0,0,0,22129,402549,2162,714645,0,0,0,0,0,0,35,35,35,714645,2162,714645,22129,402549,0,1,0,0,0
pytroll/satpy,191,60570,2978,40416,30996,703928,1788,936988,26,880353,352,380253,2995,96488,43,43,17,56635,1436,556735,28047,607440,1,1,0,1,0
pytroll/pyresample,51,18164,737,13372,6531,141749,407,194991,8,193455,71,71399,343,14580,11,11,3,1536,336,123592,6193,127169,1,1,0,1,0
docnow/twarc,62,13538,373,9470,2576,52836,234,74810,13,70083,57,29108,305,7252,15,15,2,4727,177,45702,2274,45584,1,1,0,1,0
gns3/gns3-gui,333,203845,2275,46226,4187,57213,249,83422,5,62347,20,16215,198,2718,9,9,4,21075,229,67207,3990,54495,0,1,0,0,0
gns3/gns3-server,269,55018,2208,30856,7022,98878,385,142981,17,119144,60,39746,416,7489,24,24,7,23837,325,103235,6622,91389,1,1,1,0,0
snowflakedb/snowflake-connector-python,129,38649,1703,26686,8159,127960,526,196270,17,195694,98,58446,428,9668,18,18,1,576,428,137824,7747,118292,0,0,0,0,2
snowflakedb/snowflake-ingest-python,10,676,28,374,10115,156850,669,238409,7,42419,30,13807,115,1828,23,23,16,195990,639,224602,10000,155022,1,1,0,1,1
snowflakedb/snowflake-sqlalchemy,11,2806,221,1782,18753,281044,889,419743,1,185796,14,30012,51,1425,21,21,20,233947,875,389731,18707,279619,0,2,0,0,0
scitools/iris-grib,10,7054,212,5782,33691,689835,1976,1012481,14,663204,125,143643,891,29756,41,41,27,349277,1851,868838,32808,660079,0,1,0,0,0
scitools/cartopy,33,14359,523,11219,14726,276872,913,451437,7,321763,97,108181,575,22636,17,17,10,129674,816,343256,14160,254236,0,1,0,0,0
faforever/client,190,26855,1980,20111,8766,133802,577,196834,16,107858,62,36943,348,6234,41,41,25,88976,515,159891,8449,127568,0,1,0,0,0
dschep/ntfy,29,1570,43,1072,1702,34032,103,47867,3,17219,10,5086,25,651,7,7,4,30648,93,42781,1677,33381,0,1,0,0,0
akretion/roulier,75,5572,329,3852,5133,83342,510,170405,9,153275,26,19626,140,2523,14,14,5,17130,484,150779,4993,80819,0,1,0,0,0
sec-edgar/sec-edgar,18,3769,128,1998,3789,60279,270,123542,9,66456,33,22880,173,4196,16,16,7,57086,237,100662,3621,56083,1,1,0,1,0
ckan/ckanext-harvest,39,7662,332,5960,2583,44957,142,62271,4,44923,13,8785,34,841,9,9,5,17348,129,53486,2549,44116,0,1,0,0,0
timotheus/ebaysdk-python,30,4186,188,5817,1352,31379,114,42288,4,35097,20,7737,115,2431,7,7,3,7191,94,34551,1237,28948,0,1,0,0,0
praw-dev/praw,89,20476,744,15254,1105,25355,97,37293,5,21190,18,7079,49,841,8,8,3,16103,79,30214,1058,24514,0,1,0,0,0
kubernetes-client/python,669,236021,7734,166290,4985,83674,517,146707,11,86506,57,22878,297,6588,17,17,6,60201,460,123829,4689,77086,0,0,0,0,1
ewels/multiqc,392,57481,1127,48915,23464,464229,2013,807195,18,549536,151,127145,631,19192,34,34,16,257659,1862,680050,22837,445037,0,1,0,0,0
spatialaudio/nbsphinx,6,2581,73,1461,16182,226980,1284,443678,11,155987,78,39675,334,6131,49,49,38,287691,1206,404003,15867,220849,0,1,0,0,0
oauthlib/oauthlib,69,11933,396,8581,2704,27365,128,40789,3,21669,15,7133,66,1175,5,5,2,19120,113,33656,2640,26190,1,0,1,0,0
asana/python-asana,76,5636,390,4697,3770,63894,271,90643,2,16611,9,4636,15,282,15,15,13,74032,262,86007,3755,63612,0,1,0,0,0
chyroc/wechatsogou,11,1797,52,1385,6071,101859,503,155388,6,117911,36,27756,125,1935,15,15,9,37477,467,127632,5949,99924,0,1,0,0,0
keeper-security/commander,203,64704,2323,46955,15898,208863,1090,328172,20,250014,137,74364,682,13147,37,37,17,78158,953,253808,15233,195716,1,1,0,1,0
lukasschwab/arxiv.py,3,838,44,519,15432,231685,1356,491049,1,5823,7,2124,13,713,38,38,37,485226,1349,488925,15419,230972,0,1,0,0,0
jazzband/django-oauth-toolkit,45,4828,222,2760,13338,170103,1165,250243,7,205603,150,68713,595,10540,16,16,9,44640,1015,181530,12762,159563,1,1,0,1,0
jazzband/django-payments,57,6218,372,3971,10087,135135,1531,204961,4,167558,100,42240,385,6846,10,10,6,37403,1431,162721,9714,128289,0,1,0,0,0
poliastro/poliastro,147,23279,648,16188,67177,1477671,5041,2081997,19,1836236,295,398918,2213,80141,45,45,26,245761,4746,1683079,65014,1397530,0,1,0,0,1
pseudonym117/riot-watcher,89,3223,203,2014,1086,24282,161,35987,2,16611,10,4619,18,352,6,6,4,19376,151,31368,1069,23930,0,1,0,0,0
martyzz1/heroku3.py,34,2801,268,1733,14060,185206,1265,392026,5,52763,13,7472,50,1237,41,41,36,339263,1252,384554,14011,183969,0,2,0,0,0
pytrip/pytripgui,109,7774,715,5307,22992,493040,1342,773327,8,419287,141,146859,1203,28748,20,20,12,354040,1201,626468,21806,464292,0,1,0,0,0
open2c/bioframe,19,6474,130,5646,20335,409383,1178,625076,6,439372,130,169080,1125,38199,21,21,15,185704,1048,455996,19247,371184,0,1,0,0,0
astropy/astroquery,245,52235,1458,41599,17884,351898,1108,493259,13,430162,193,198446,1349,44549,26,26,13,63097,915,294813,16553,307349,0,1,0,0,1
getnikola/nikola,165,28402,903,16533,9887,144437,1112,368878,21,350543,126,67700,690,14477,26,26,5,18335,986,301178,9210,129960,0,1,0,0,0
containerbuildsystem/atomic-reactor,85,19862,933,14428,2886,54149,257,75915,5,35154,23,9343,134,3004,18,18,13,40761,234,66572,2752,51145,0,1,0,0,0
networktocode/pyntc,25,7747,402,6562,15379,205080,1390,310369,12,141037,61,34088,275,4718,35,35,23,169332,1329,276281,15108,200362,0,2,0,0,0
maxplanck-ie/snakepipes,7,1225,35,986,20418,386061,1154,527100,3,167879,10,2837,28,362,46,46,43,359221,1144,524263,20390,385699,0,1,0,0,0
ploxiln/fab-classic,31,7386,266,5819,2553,25319,108,37925,1,998,1,998,2,12,5,5,4,36927,107,36927,2551,25307,0,1,0,0,0
kibitzr/kibitzr,49,3325,254,2030,32100,469921,1700,666207,21,559681,113,72822,519,9870,48,48,27,106526,1587,593385,31582,460051,0,1,0,0,1
ma1co/sony-pmca-re,55,6421,651,4101,8655,126003,1320,205923,7,107195,62,33113,466,9022,14,14,7,98728,1258,172810,8189,116981,0,0,0,0,1
django-helpdesk/django-helpdesk,90,10951,348,5331,24087,306412,2013,461604,17,258097,180,83794,815,15730,48,48,31,203507,1833,377810,23308,290682,0,1,0,0,0
4dn-dcic/tibanna,37,9551,421,7739,6677,90241,361,137940,6,70639,36,23647,172,2558,13,13,7,67301,325,114293,6507,87683,0,1,0,0,0
nsacyber/walkoff,216,39773,1629,24504,25305,331530,1673,581872,27,238486,197,87939,1010,19205,67,67,40,343386,1476,493933,24303,312325,4,0,1,3,1
kivy/kivy-ios,54,4095,185,2500,9510,141622,506,239846,10,124450,74,30953,285,5256,21,21,11,115396,432,208893,9225,136366,0,1,0,0,0
home-assistant-libs/pychromecast,28,5902,329,4147,2119,37226,153,57369,5,23894,20,8168,69,1112,10,10,5,33475,133,49201,2050,36114,0,1,0,0,0
zqfang/gseapy,12,6580,188,7086,26886,598675,1636,882044,11,747346,189,235668,1735,61188,22,22,11,134698,1447,646376,25188,537487,0,1,0,0,0
mapbox/rasterio,52,11265,308,7798,6424,136491,361,189513,8,178476,48,52164,219,7072,10,10,2,11037,313,137349,6208,129419,0,1,0,0,0
buildbot/buildbot,420,78275,4552,51158,30492,389487,1278,573705,11,323939,112,126925,631,16058,26,26,15,249766,1166,446780,29878,373429,0,1,0,0,0
burnash/gspread,9,5679,224,4901,2885,53212,412,103966,1,966,1,495,3,138,14,14,13,103000,411,103471,2883,53074,0,1,0,0,0
landlab/landlab,322,96091,2192,70145,40152,879621,2772,1368100,14,1036316,247,307128,2097,73399,40,40,26,331784,2525,1060972,38089,806222,0,1,0,0,0
althonos/instalooter,18,2353,106,1581,4470,71983,310,104200,11,83115,33,17865,138,2512,16,16,5,21085,277,86335,4332,69471,0,1,0,0,0
yashaka/selene,35,6220,443,3079,13323,164197,866,269199,3,134860,31,3391,79,875,23,23,20,134339,835,265808,13245,163322,0,1,0,0,0
wechatpy/wechatpy,110,19471,954,14307,1269,28925,94,41912,6,36187,24,10337,134,3178,9,9,3,5725,70,31575,1135,25747,0,1,0,0,0
liqd/a4-opin,327,13178,401,2419,30531,395639,3411,656949,23,206493,94,48333,369,8225,76,76,53,450456,3317,608616,30180,387414,0,2,0,0,0
liqd/adhocracy4,330,14096,716,5736,25092,333787,2586,501564,17,236062,226,109933,1399,26528,45,45,28,265502,2360,391631,23732,307259,0,2,0,0,0
snare/voltron,44,7615,356,4313,5867,96655,603,243738,12,191229,71,35762,264,5819,25,25,13,52509,532,207976,5606,90836,0,1,0,0,0
fresna/powerplantmatching,20,6915,153,4854,34403,776918,2569,1168407,22,932661,211,243457,1616,56834,39,39,17,235746,2358,924950,32826,720084,0,1,0,0,0
vmware/photon,37,10184,539,7652,919,22903,83,33782,2,16611,9,4478,17,350,6,6,4,17171,74,29304,902,22553,0,1,0,0,0
gwpy/gwpy,153,38210,1176,27420,33817,697990,2163,1035163,19,815622,236,295367,1563,60131,37,37,18,219541,1927,739796,32276,637859,0,1,0,0,1
meejah/txtorcon,27,11954,629,8565,16106,189513,865,312429,9,240736,120,87979,495,8805,18,18,9,71693,745,224450,15622,180708,1,0,0,1,0
bigchaindb/bigchaindb,68,8419,423,5662,10529,150455,599,227527,13,119293,62,39968,231,4574,32,32,19,108234,537,187559,10299,145881,4,1,0,4,0
ktbyers/netmiko,204,17696,910,12932,6479,81547,464,123383,6,78953,33,18257,178,3540,13,13,7,44430,431,105126,6306,78007,0,1,0,0,0
openpathsampling/openpathsampling,210,55010,3181,41029,32013,721770,2226,1043474,15,911177,243,279541,1872,65461,27,27,12,132297,1983,763933,30182,656309,0,1,0,0,0
pagarme/pagarme-python,37,638,81,232,1383,30475,108,44222,2,16611,8,4321,14,279,9,9,7,27611,100,39901,1369,30196,0,1,0,0,0
kapsiry/sikteeri,74,10230,547,6651,17373,225157,1603,366261,11,267117,177,91938,1082,20291,21,21,10,99144,1426,274323,16313,204866,0,1,0,0,0
approvals/approvaltests.python,103,3303,356,1982,15085,273426,985,391665,7,26173,18,10093,60,1392,37,37,30,365492,967,381572,15025,272034,0,1,0,0,0
chrismattmann/tika-python,9,1486,48,959,4996,77938,279,112902,1,27538,2,1369,31,472,15,15,14,85364,277,111533,4965,77466,0,1,0,0,0
moepman/acertmgr,16,1914,92,1344,2488,24887,105,36759,1,17639,20,9745,72,856,3,3,2,19120,85,27014,2423,24031,1,0,0,1,0
scille/parsec-cloud,146,30439,1151,17940,5468,83136,376,119367,10,90311,55,33178,269,5923,18,18,8,29056,321,86189,5213,77213,0,1,0,0,0
icloud-photos-downloader/icloud_photos_downloader,33,3462,165,2491,7673,102230,615,156732,11,90916,65,36936,401,7356,29,29,18,65816,550,119796,7279,94874,0,2,0,0,0
dials/dials,427,126767,3964,100015,4306,65498,229,94030,7,70788,19,12259,48,1008,19,19,12,23242,210,81771,4259,64490,0,1,0,0,0
rollbar/pyrollbar,47,4997,295,3276,943,22550,74,33712,3,17609,10,6353,17,337,6,6,3,16103,64,27359,926,22213,0,1,0,0,0
lektor/lektor,59,15667,1175,11271,13516,201328,913,340907,17,97890,83,55924,405,8651,26,26,9,243017,830,284983,13115,192677,0,1,0,0,0
spotdl/spotify-downloader,53,11434,208,7563,4505,71178,252,98976,4,31696,25,11441,142,3154,15,15,11,67280,227,87535,4363,68024,0,1,0,0,0
serhatbolsu/robotframework-appiumlibrary,19,2662,207,2114,17559,185168,1200,318716,5,198127,24,9322,105,1381,19,19,14,120589,1176,309394,17456,183787,0,1,0,0,0
tilezen/vector-datasource,356,54566,2366,46926,18296,327494,1156,450734,11,326759,106,54346,267,4811,33,33,22,123975,1050,396388,18033,322683,0,1,0,0,0
tilezen/tilequeue,43,8993,415,5595,17899,321128,1102,441498,10,339086,37,23337,144,3512,27,27,17,102412,1065,418161,17758,317616,0,1,0,0,0
mozilla/mozilla-django-oidc,10,1298,60,965,14178,179641,1164,263660,7,215014,81,33212,270,4448,15,15,8,48646,1083,230448,13915,175193,1,1,0,1,0
mozilla/pontoon,277,29746,1034,16281,1369,28728,114,41614,2,16611,9,4478,17,350,8,8,6,25003,105,37136,1352,28378,0,1,0,0,0
hdfgroup/hsds,76,27665,611,23867,13397,222845,735,314886,21,271428,94,75743,468,9839,33,33,12,43458,641,239143,12943,213006,2,1,1,1,0
hdfgroup/h5pyd,41,16402,620,13597,13894,242242,1166,386994,6,179552,27,29178,72,2189,37,37,31,207442,1139,357816,13823,240053,0,2,0,0,0
jbarlow83/ocrmypdf,46,10445,410,7146,9584,129208,524,205520,9,153686,75,56860,643,12671,16,16,7,51834,449,148660,8945,116537,0,1,0,0,0
geopython/owslib,72,26566,1113,19691,2006,38643,144,56997,6,38258,14,8331,56,1350,10,10,4,18739,130,48666,1950,37293,0,1,0,0,0
geopython/pywps,49,8131,412,5587,22165,379390,1006,572553,18,493824,159,193976,892,21901,38,38,20,78729,847,378577,21274,357489,0,1,0,0,0
geopython/geohealthcheck,58,9731,405,5621,28260,387559,1652,678533,27,347273,149,107352,680,16338,54,54,27,331260,1503,571181,27592,371221,2,1,0,2,0
sphinx-gallery/sphinx-gallery,23,6817,187,4734,10250,141371,794,315332,2,108508,10,6173,21,210,23,23,21,206824,784,309159,10232,141161,0,1,0,0,0
nexb/aboutcode-toolkit,24,9063,288,6197,3344,43525,286,70362,9,69871,110,40572,490,8374,11,11,2,491,176,29790,2857,35151,0,1,0,0,0
yandex/yandex-tank,123,21640,1520,16148,23536,381973,1542,604995,19,515334,106,88667,520,12032,34,34,15,89661,1436,516328,23022,369941,0,2,0,0,1
getsentry/responses,5,2023,99,1495,1229,26805,91,38637,4,33910,29,12011,139,2965,6,6,2,4727,62,26626,1092,23840,0,1,0,0,0
hyperspy/hyperspyui,95,16947,1042,11393,96678,1671872,6822,2728008,37,1778061,502,415159,2743,75027,101,101,64,949947,6320,2312849,93986,1596845,0,1,0,0,0
hyperspy/hyperspy,237,91706,2833,68260,79628,1424234,5017,2326605,44,1771790,438,440295,2830,94304,83,83,39,554815,4579,1886310,76834,1329930,0,1,0,0,0
achael/eht-imaging,58,48750,1199,43153,49587,1075761,3725,1650346,21,1255403,346,450575,2628,93121,52,52,31,394943,3379,1199771,47008,982640,0,0,0,0,1
ucfopen/canvasapi,79,16266,794,14467,1486,32506,108,54064,5,45703,30,21640,161,4135,9,9,4,8361,78,32424,1326,28371,0,1,0,0,0
broadinstitute/fiss,15,6134,274,5367,9703,157882,953,268370,1,998,1,998,5,59,30,30,29,267372,952,267372,9698,157823,0,1,0,0,0
sys-bio/tellurium,90,56662,2229,45170,72278,1531052,4786,2269582,26,1709881,233,513795,1709,62155,69,69,43,559701,4553,1755787,70610,1468897,0,1,0,0,0
soco/soco,39,16331,589,11128,1266,27814,109,41507,6,25404,14,6066,32,856,9,9,3,16103,95,35441,1235,26958,0,1,0,0,0
twitterdev/twitter-python-ads-sdk,16,2775,162,1099,4382,73318,315,105741,6,44473,7,5976,82,1733,19,19,13,61268,308,99765,4301,71585,0,1,0,0,0
cog-creators/red-discordbot,190,72166,2738,56933,14368,224887,1130,452244,30,336628,152,92604,683,13797,43,43,13,115616,978,359640,13700,211090,1,0,1,0,0
projectq-framework/projectq,222,41810,1849,29211,23525,559418,1653,820053,9,674106,91,99783,494,20767,20,20,11,145947,1562,720270,23034,538651,0,1,0,0,0
jupyter/kernel_gateway,30,2947,143,1858,27458,388569,2132,687486,15,117497,61,37876,266,5989,87,87,72,569989,2071,649610,27210,382580,0,1,0,0,0
jupyter/nbgrader,135,17657,695,10809,41082,587613,2646,985795,18,370224,147,171275,921,21623,103,103,85,615571,2499,814520,40185,565990,0,1,0,0,0
aliyun/aliyun-oss-python-sdk,34,18887,1021,13977,6840,85256,449,133712,7,97247,43,17824,193,3592,13,13,6,36465,406,115888,6647,81664,0,2,0,0,0
whynothugo/django-mercadopago,33,1990,37,399,11946,158582,1115,232649,6,195482,73,35996,246,4122,16,16,10,37167,1042,196653,11711,154460,0,1,0,0,0
armmbed/mbed-cli,7,3981,212,3005,4257,66979,388,110164,2,10961,15,6725,64,1205,18,18,16,99203,373,103439,4194,65774,0,1,0,0,0
snok/django-auth-adfs,47,2019,50,952,12496,156191,1098,230022,7,199242,124,53675,554,10494,13,13,6,30780,974,176347,11951,145697,1,1,0,1,0
goshippo/shippo-python-client,10,1254,76,790,1216,25479,124,37612,3,21676,17,6648,40,1199,6,6,3,15936,107,30964,1176,24280,1,1,0,1,0
atlassian-api/atlassian-python-api,47,23877,1554,20610,1588,34022,165,49410,6,32309,16,6090,29,664,10,10,4,17101,149,43320,1560,33358,0,1,0,0,0
picklepete/pyicloud,15,3054,205,2312,4906,65227,279,96218,7,43347,32,11918,188,3541,18,18,11,52871,247,84300,4718,61686,0,2,0,0,0
donnemartin/saws,25,2800,89,1716,12188,141914,986,324241,5,152692,63,25501,312,7336,17,17,12,171549,923,298740,11879,134578,1,0,0,1,0
pahaz/sshtunnel,4,2323,85,1564,3607,44474,183,63779,1,20421,14,9556,113,2193,6,6,5,43358,169,54223,3494,42281,0,1,0,0,0
scrapy/scrapy,176,22846,1556,15579,18214,218391,1037,356948,17,255397,165,117812,799,13981,36,36,19,101551,872,239136,17427,204410,1,1,0,1,0
scrapy/scrapyd,26,1779,181,1109,19741,233702,1207,379173,7,232098,112,76992,458,7395,37,37,30,147075,1095,302181,19287,226307,0,2,0,0,0
autopkg/autopkg,71,19561,875,13149,7848,101640,495,143239,6,50068,20,10458,137,2138,31,31,25,93171,475,132781,7711,99502,0,0,0,0,1
jrnl-org/jrnl,49,5251,238,3618,7019,89220,657,233184,11,183917,62,25335,267,5635,20,20,9,49267,595,207849,6753,83585,1,0,0,1,0
archlinux/arch-security-tracker,52,5526,257,3606,21978,305950,1217,445969,25,368397,166,144562,769,18098,40,40,15,77572,1051,301407,21233,287852,1,1,0,1,0
cmu-delphi/delphi-epidata,145,20477,739,13809,2630,43169,159,62308,8,57202,32,18594,155,3579,13,13,5,5106,127,43714,2480,39590,1,1,0,1,0
choderalab/yank,24,15818,456,12221,21252,293112,1319,552879,0,0,0,0,0,0,45,45,45,552879,1319,552879,21252,293112,0,2,0,0,0
kenfar/datagristle,26,9013,381,6901,25836,340215,1035,509837,14,315230,66,75605,229,6147,37,37,23,194607,969,434232,25610,334068,0,1,0,0,0
uw-hydro/rvic,26,6442,109,5105,26029,577591,1570,850617,8,719459,143,184496,1232,44484,20,20,12,131158,1427,666121,24830,533107,0,1,0,0,0
datadog/datadogpy,76,10465,417,7593,883,22268,73,32798,2,16611,8,4321,14,279,5,5,3,16187,65,28477,869,21989,0,1,0,0,0
vijos/vj4,80,10986,772,6659,9114,126979,609,224359,22,131789,79,41818,379,7928,35,35,13,92570,530,182541,8741,119051,1,1,1,0,0
bluesky/databroker,59,18899,904,14207,29296,572507,1630,798327,30,663257,319,369194,2360,73720,53,53,23,135070,1311,429133,26976,498787,0,0,0,0,1
translate/translate,413,89152,4500,62828,1705,34002,119,50065,2,11713,8,3172,35,1275,8,8,6,38352,111,46893,1670,32727,0,1,0,0,0
pypsa/atlite,25,6141,185,4531,29996,691703,1767,915758,22,839579,318,368571,2747,91880,45,45,23,76179,1449,547187,27293,599823,0,1,0,0,0
esgf/esgf-pyclient,14,1771,79,1158,6450,88917,342,129266,10,88043,35,20575,219,4414,22,22,12,41223,307,108691,6233,84503,1,1,0,1,0
plotly/dash,67,13078,595,9648,17804,546867,2006,746534,10,694460,34,30701,104,2615,24,24,14,52074,1972,715833,17701,544252,0,1,0,0,0
eoxserver/eoxserver,448,61806,2339,32641,32456,490009,2562,771165,21,514245,209,117585,977,18599,55,55,34,256920,2353,653580,31516,471410,0,1,0,0,0
wwood/singlem,77,15980,524,12733,51711,982717,3430,1607054,14,941930,253,352218,1950,61981,52,52,38,665124,3177,1254836,49795,920736,0,1,0,0,0
sumologic/sumologic-python-sdk,18,1067,90,428,882,22187,73,32714,3,27987,20,7737,121,2644,5,5,2,4727,53,24977,761,19543,0,1,0,0,0
salsita/shishito,49,4599,227,2783,15003,184944,1039,300831,7,201212,51,23378,183,2913,28,28,21,99619,988,277453,14821,182031,0,1,0,0,0
tchellomello/python-amcrest,22,4408,356,3026,1103,25289,86,37608,2,16611,10,4793,18,346,7,7,5,20997,76,32815,1085,24943,0,1,0,0,0
tensorlayer/tensorlayer,111,32488,1046,22356,22051,639348,1766,885941,15,737161,240,268400,1882,77094,24,24,9,148780,1526,617541,20175,562254,0,1,0,0,0
pycontribs/jira,9,7750,328,6518,1946,39042,216,57922,7,38260,25,9355,151,3087,11,11,4,19662,191,48567,1795,35955,0,1,0,0,0
graphbrain/graphbrain,63,5958,384,4665,33634,742867,2815,1173313,16,841402,120,139073,633,24120,59,59,43,331911,2695,1034240,33006,718747,0,1,0,0,0
fabfuel/ecs-deploy,6,2480,128,1889,6707,97104,473,144313,7,117754,30,18975,130,2153,13,13,6,26559,443,125338,6577,94951,0,1,0,0,0
nschloe/meshzoo,0,0,0,0,10577,198323,1018,384766,0,0,0,0,0,0,30,30,30,384766,1018,384766,10577,198323,0,2,0,0,0
zulko/moviepy,166,20983,701,16217,7169,167559,486,235315,4,198227,39,60308,241,10229,10,10,6,37088,447,175007,6929,157330,0,1,0,0,0
home-assistant-ecosystem/home-assistant-cli,25,4289,192,2278,6975,105879,595,198421,19,159223,69,41206,572,9840,31,31,12,39198,526,157215,6408,96039,1,1,0,1,0
home-assistant-ecosystem/python-mystrom,8,1077,92,607,4381,67866,233,98599,10,93740,36,23098,222,4306,14,14,4,4859,197,75501,4163,63560,1,1,0,1,0
oemof/feedinlib,13,3493,84,2625,17860,473267,1116,630161,5,583259,128,167644,1142,39131,15,15,10,46902,988,462517,16751,434136,0,1,0,0,0
sassoftware/python-swat,71,21065,1221,35589,10496,254970,588,339124,8,326878,146,171284,1297,42360,11,11,3,12246,442,167840,9234,212610,0,0,0,0,1
bundlewrap/bundlewrap,79,17493,953,13743,6455,88327,339,133311,10,97721,65,36210,416,7401,16,16,6,35590,274,97101,6041,80926,1,1,0,1,0
wradlib/wradlib,38,18735,461,14581,34989,754732,1986,1076552,17,916329,299,379239,2733,95144,38,38,21,160223,1687,697313,32298,659588,0,1,0,0,0
ccrisan/motioneye,28,9845,386,8042,5570,65861,238,94113,4,93746,25,19230,149,3126,5,5,1,367,213,74883,5423,62735,1,0,0,1,0
taspinar/twitterscraper,6,789,20,645,2485,42110,161,61939,3,26069,20,10454,104,1355,11,11,8,35870,141,51485,2381,40755,0,1,0,0,0
xknx/xknx,152,22588,1346,13308,2522,25248,112,37537,3,18417,14,4361,50,567,5,5,2,19120,98,33176,2474,24681,1,0,0,1,0
morucci/repoxplorer,37,5264,198,3483,9967,139085,717,208834,11,121217,46,21597,158,3579,28,28,17,87617,671,187237,9810,135506,2,1,0,2,0
sunscrapers/djoser,38,1606,75,745,15743,196367,1565,291997,7,186426,108,44693,414,6629,23,23,16,105571,1457,247304,15345,189738,0,2,0,0,0
fizzadar/pyinfra,142,23621,752,17206,12573,162295,735,247862,16,188549,115,64521,619,11923,28,28,12,59313,620,183341,11974,150372,1,1,0,1,0
aws/aws-parallelcluster,310,71222,2856,47545,48819,581763,747,831986,19,180081,97,58213,501,8526,91,91,72,651905,650,773773,48323,573237,0,1,0,0,0
scrapy-plugins/scrapy-zyte-smartproxy,4,444,31,311,19742,233783,1207,379257,3,51361,4,661,7,79,37,37,34,327896,1203,378596,19735,233704,1,2,0,1,0
cs50/help50,0,0,0,0,4302,62197,243,88920,0,0,0,0,0,0,16,16,16,88920,243,88920,4302,62197,0,2,0,0,0
gandi/gandi.cli,65,11039,547,7474,3096,52557,175,76305,5,60202,28,16083,140,2355,8,8,3,16103,147,60222,2958,50202,0,1,0,0,0
staticafi/symbiotic,61,9534,583,6629,5480,83299,286,129450,0,0,0,0,0,0,18,18,18,129450,286,129450,5480,83299,0,1,0,0,0
cve-search/cve-search,80,13092,511,6919,16573,241488,1163,363225,14,157891,90,70174,360,8780,43,43,29,205334,1073,293051,16215,232708,0,0,0,0,1
feeicn/cobra,24,7205,257,5734,35212,649490,2088,1160271,1,40304,2,985,2,13,31,31,30,1119967,2086,1159286,35210,649477,0,1,0,0,0
flyingrub/scdl,4,1088,23,858,2807,44923,238,69188,8,43475,24,11582,99,1432,15,15,7,25713,214,57606,2718,43491,0,1,0,0,0
django-salesforce/django-salesforce,52,7368,356,3834,9928,130909,980,193230,5,170194,119,56642,479,8248,10,10,5,23036,861,136588,9457,122661,0,1,0,0,0
spacetelescope/drizzlepac,133,72936,1286,62053,67874,1410487,4789,2058051,34,1530740,591,651593,4437,160531,83,83,49,527311,4198,1406458,63495,1249956,1,1,0,1,1
theqrl/qrl,131,32812,1480,16421,16685,214990,1160,353834,14,125057,66,41310,259,5081,54,54,40,228777,1094,312524,16430,209909,1,1,0,1,2
comictagger/comictagger,82,17697,714,12618,4692,81686,343,121786,13,100904,43,25031,131,3309,19,19,6,20882,300,96755,4561,78377,0,1,0,0,0
gregreen/dustmaps,24,5668,169,4275,29860,657415,1936,973227,13,779777,146,207919,930,35285,27,27,14,193450,1790,765308,28935,622130,0,0,0,0,1
20c/vaping,18,2633,128,1709,8552,116795,461,178882,7,31222,19,8241,54,1134,22,22,15,147660,442,170641,8501,115661,0,2,0,0,0
mopidy/mopidy-spotify,13,1772,111,1379,5697,84341,317,122908,5,66812,30,10562,155,2973,12,12,7,56096,287,112346,5550,81368,0,1,0,0,0
evonove/mkm-sdk,12,1089,29,348,1329,31802,156,45928,2,6786,2,167,2,49,7,7,5,39142,154,45761,1327,31753,0,1,0,0,0
dalibo/temboard,149,24952,1300,16517,19107,261053,778,399266,10,351710,157,184671,1027,24142,19,19,9,47556,621,214595,18098,236911,1,0,0,1,0
zestedesavoir/zds-site,458,49889,2207,29054,30531,388520,3033,860107,34,592126,266,116760,1250,21003,77,77,43,267981,2767,743347,29373,367517,1,3,1,0,0
lyft/confidant,61,9422,306,6636,25255,320697,1373,474498,30,300590,174,91143,900,17711,69,69,39,173908,1199,383355,24390,302986,1,1,0,1,0
samuelcolvin/grablib,8,925,49,679,2170,40794,118,57389,4,38117,26,11617,158,3336,7,7,3,19272,92,45772,2012,37458,0,1,0,0,0
open-power/op-test,131,40370,1966,28628,3198,45561,177,64998,6,35816,27,12664,189,4322,16,16,10,29182,150,52334,3009,41239,0,1,0,0,0
smartsheet-platform/smartsheet-python-sdk,182,21065,1477,10751,1441,30625,126,45137,5,25349,13,8231,50,1283,8,8,3,19788,113,36906,1391,29342,0,0,0,0,1
cuthbertlab/music21,254,289745,4457,110529,16166,301396,1038,528128,6,322150,41,39881,103,2525,23,23,17,205978,997,488247,16063,298871,0,1,0,0,0
googlecloudplatform/perfkitbenchmarker,650,142569,6061,91001,34478,607539,2267,962238,28,643661,254,260996,1933,60137,58,58,30,318577,2013,701242,32586,547402,0,2,0,0,0
googlecloudplatform/cloud-debug-python,21,4093,138,2949,11143,169059,914,281651,4,34467,15,6788,34,630,35,35,31,247184,899,274863,11109,168429,0,2,0,0,0
jarun/buku,9,1571,106,1085,4138,48370,193,74148,0,0,0,0,0,0,9,9,9,74148,193,74148,4138,48370,0,1,0,0,0
safetyculture/safetyculture-sdk-python,13,2728,117,2149,6907,98307,485,149568,9,85414,25,21086,202,6865,19,19,10,64154,460,128482,6705,91442,0,2,0,0,0
beeware/briefcase,60,16184,622,12683,15011,233401,1390,531068,11,166157,64,31831,313,6283,36,36,25,364911,1326,499237,14699,227118,0,1,0,0,0
mfussenegger/cr8,23,3489,217,2363,3992,58854,650,159230,10,145529,31,19503,139,4557,17,17,7,13701,619,139727,3859,54297,1,0,0,1,0
tuxemon/tuxemon,365,43542,1606,28244,9518,159147,647,241064,17,198245,132,83255,766,18327,25,25,8,42819,515,157809,8753,140820,0,1,0,0,0
insrapperswil/nuts,23,1636,160,951,26945,373241,1722,548504,3,32428,22,10366,53,677,55,55,52,516076,1700,538138,26896,372564,0,3,0,0,0
datalad/datalad,205,69995,2167,49144,11248,170263,885,280586,17,222598,87,32716,348,7199,30,30,13,57988,798,247870,10901,163064,0,2,0,0,0
hadrieng/insilicoseq,16,2723,61,2230,23143,504331,1482,718860,7,623187,88,109822,425,17920,12,12,5,95673,1394,609038,22722,486411,0,1,0,0,0
mechanicalsoup/mechanicalsoup,7,1316,67,1014,1759,35627,124,51915,3,23557,12,9317,32,1002,9,9,6,28358,112,42598,1727,34625,0,1,0,0,0
k4cg/nichtparasoup,33,3280,250,1852,4464,56943,224,81038,4,58381,36,21779,211,4352,8,8,4,22657,188,59259,4256,52591,1,0,0,1,0
openidc/pyoidc,105,28170,1165,19921,10735,142697,764,224764,10,164907,94,47630,532,9440,21,21,11,59857,670,177134,10214,133257,1,1,0,1,0
freakboy3742/pyxero,12,2271,120,1422,4287,64315,292,93494,5,41201,27,9568,133,3154,13,13,8,52293,265,83926,4155,61161,0,2,0,0,0
city-of-helsinki/respa,253,21303,935,9959,46415,605958,4807,1230644,45,825589,311,158189,1597,29220,104,104,59,405055,4496,1072455,44898,576738,1,1,0,1,0
learningequality/studio,268,28213,1056,14863,46370,594656,3720,938564,36,456776,324,144361,1588,28776,96,96,60,481788,3396,794203,44850,565880,1,1,0,1,0
danielperna84/ha-philipsjs,10,12840,116,1737,4268,52593,229,76739,8,56613,58,21355,379,6132,11,11,3,20126,171,55384,3891,46461,1,0,0,1,1
packethost/packet-python,24,1756,185,1308,882,22187,73,32714,2,16611,9,4478,19,373,5,5,3,16103,64,28236,863,21814,0,1,0,0,0
osmcode/pyosmium,11,1912,121,993,882,22187,73,32714,3,27987,19,7580,117,2557,5,5,2,4727,54,25134,765,19630,0,1,0,0,0
goldmann/docker-squash,12,1975,76,1724,1839,38381,169,53916,5,46083,34,11547,156,3309,8,8,3,7833,135,42369,1683,35072,0,1,0,0,0
xtrinch/fcm-django,23,1445,56,634,21463,295799,1932,467309,4,183925,36,28262,94,1267,43,43,39,283384,1896,439047,21379,294532,0,2,0,0,0
relekang/python-semantic-release,23,3687,168,2675,12578,164779,1097,352517,11,93816,57,28866,348,6902,37,37,26,258701,1040,323651,12233,157877,0,2,0,0,0
plantbreeding/api,18,3320,108,2615,1603,31415,120,45858,3,27987,20,7737,122,2659,6,6,3,17871,100,38121,1481,28756,0,1,0,0,0
dmtf/python-redfish-library,12,4678,211,3938,1586,31049,128,46348,8,24079,16,8057,82,1187,13,13,5,22269,112,38291,1504,29862,0,1,0,0,0
dmtf/redfish-interface-emulator,76,9389,413,4951,4383,75110,258,108493,7,61298,34,22819,140,2977,19,19,12,47195,224,85674,4246,72133,0,1,0,0,0
redhatqe/widgetastic.core,34,8395,531,5604,10926,133598,581,218760,3,132892,22,5188,51,930,20,20,17,85868,559,213572,10879,132668,0,1,0,0,0
redhatqe/wrapanapi,37,15271,1199,11710,70021,1170446,8657,2051977,61,925476,251,273802,1491,35240,160,160,99,1126501,8406,1778175,68539,1135206,1,0,0,1,1
cokelaer/bioservices,67,24257,880,16336,29637,517398,1816,793798,19,571701,209,202825,1363,42212,47,47,28,222097,1607,590973,28315,475186,0,1,0,0,0
napalm-automation/napalm,58,25047,608,21332,13991,200013,1173,331429,15,227412,70,46865,425,8832,34,34,19,104017,1103,284564,13570,191181,0,2,0,0,0
identitypython/pysaml2,150,65067,2945,32980,5602,81015,325,132967,8,53040,31,18492,170,2987,15,15,7,79927,294,114475,5433,78028,1,1,0,1,0
identitypython/djangosaml2,15,1875,84,1286,17304,218539,1352,349642,11,262782,142,87261,921,17938,20,20,9,86860,1210,262381,16396,200601,1,1,0,1,0
darknessomi/musicbox,18,4494,226,3570,1362,30141,90,43575,3,27987,20,7737,119,2623,7,7,4,15588,70,35838,1243,27518,0,1,0,0,0
mvexel/overpass-api-python-wrapper,7,534,22,337,7087,155817,456,215139,4,28166,16,6522,28,615,14,14,10,186973,440,208617,7064,155202,0,1,0,0,0
poppy-project/pypot,89,13367,871,8101,26124,567691,1682,957726,4,423017,44,57065,207,8057,12,12,8,534709,1638,900661,25921,559634,0,1,0,0,0
kalaspuff/tomodachi,43,9042,241,7017,6018,84151,320,124215,11,68686,32,17180,131,2180,25,25,14,55529,288,107035,5895,81971,1,0,1,0,0
transifex/transifex-client,18,4397,166,3520,2020,38009,147,56150,6,49835,31,17115,98,2018,10,10,4,6315,116,39035,1924,35991,0,1,0,0,0
geopandas/geopandas,44,22757,644,18594,11586,268972,682,355781,8,339039,164,177214,1370,46458,17,17,9,16742,518,178567,10261,222514,0,1,0,0,0
obsidianforensics/hindsight,27,9181,301,7531,882,22187,73,32714,0,0,0,0,0,0,5,5,5,32714,73,32714,882,22187,0,1,0,0,0
streamlink/streamlink,252,49044,2179,31097,5671,84729,392,132620,10,126061,44,13087,228,4759,13,13,3,6559,348,119533,5444,79970,0,0,0,0,1
sunpy/sunpy,197,45293,1757,30069,13923,307654,899,423080,11,407807,186,203096,1256,48409,17,17,6,15273,713,219984,12701,259245,1,0,0,1,0
opsdroid/opsdroid,95,16773,698,12341,14444,215527,1264,421188,31,188871,106,69968,791,15404,61,61,30,232317,1158,351220,13664,200123,1,0,1,0,0
http-apis/hydrus,31,7849,178,3294,34962,479039,1926,824603,15,411042,153,176515,905,20481,64,64,49,413561,1773,648088,34069,458558,1,1,0,1,0
jswhit/pygrib,2,159,3,24,4035,105155,261,143419,1,133985,1,186,1,45,3,3,2,9434,260,143233,4034,105110,0,1,0,0,0
python-gitlab/python-gitlab,89,15162,491,7419,1077,24362,107,36523,3,20420,10,5291,31,469,6,6,3,16103,97,31232,1046,23893,0,1,0,0,0
marketsquare/robotframework-requests,24,2822,145,2047,5202,52527,306,83596,4,78869,36,14171,136,2486,6,6,2,4727,270,69425,5067,50041,0,1,0,0,0
hvac/hvac,66,17663,532,15585,1144,25870,86,38377,4,33650,22,8703,88,1727,6,6,2,4727,64,29674,1056,24143,0,1,0,0,0
metomi/rose,131,34089,1183,23439,12853,190944,513,290362,5,242214,32,51924,115,3097,14,14,9,48148,481,238438,12740,187847,0,1,0,0,0
plamere/spotipy,7,3750,207,3105,2578,44866,138,62105,4,28985,21,8735,122,2647,8,8,4,33120,117,53370,2456,42219,0,1,0,0,0
pnx-si/taxhub,64,5821,202,3252,28116,388681,1529,564733,21,411813,134,117000,565,13911,54,54,33,152920,1395,447733,27562,374770,0,2,0,0,0
locustio/locust,38,8898,412,6155,10994,141213,662,220549,15,162547,96,63024,496,10219,29,29,14,58002,566,157525,10511,130994,0,1,0,0,0
darkreactions/drp,240,22875,802,10927,12153,120973,172,222853,3,27987,20,7737,120,2636,11,11,8,194866,152,215116,12033,118337,0,1,0,0,0
whaleshark-team/cobra,24,7205,257,5734,35212,649490,2088,1160271,1,40304,2,989,2,16,31,31,30,1119967,2086,1159282,35210,649474,0,1,0,0,0
thombashi/tcconfig,37,5162,271,3766,6242,96919,596,188837,17,169754,104,36826,445,8479,23,23,6,19083,492,152011,5801,88440,0,1,0,0,0
redcap-tools/pycap,23,2830,64,2211,1009,23350,76,34288,4,29561,21,9186,128,2797,6,6,2,4727,55,25102,881,20553,0,1,0,0,0
nandaka/pixivutil2,38,14537,470,12040,5051,85271,324,128090,12,102742,50,31376,358,8471,18,18,6,25348,274,96714,4693,76800,0,0,0,0,1
hhursev/recipe-scrapers,259,12410,2267,7476,5264,84245,370,134245,8,48996,34,18827,211,5099,18,18,10,85249,336,115418,5053,79146,0,1,0,0,0
jsvine/pdfplumber,18,3292,199,2494,4941,68993,263,110347,3,68985,31,28801,207,3375,7,7,4,41362,232,81546,4735,65618,0,1,0,0,0
mikf/gallery-dl,230,55064,2680,30520,882,22187,73,32714,3,27987,18,7395,53,1102,5,5,2,4727,55,25319,829,21085,0,1,0,0,0
pyupio/safety,23,5477,253,4295,4325,69857,219,100494,9,68229,39,25997,206,3908,12,12,3,32265,180,74497,4120,65949,0,1,0,0,0
geotab/mygeotab-python,11,1521,84,1091,3606,59749,200,92495,11,86307,43,39603,167,4333,17,17,6,6188,157,52892,3444,55416,1,1,0,1,0
koalalorenzo/python-digitalocean,26,3999,250,2982,1099,25031,87,36404,3,20301,14,7042,129,2216,6,6,3,16103,73,29362,970,22815,0,1,0,0,0
hugapi/hug,42,6207,442,3695,1332,29408,155,46187,3,30084,21,11628,39,1061,6,6,3,16103,134,34559,1294,28347,0,1,0,0,0
gocardless/gocardless-pro-python,78,8455,772,4540,1715,27090,151,42148,2,16611,9,4478,19,373,7,7,5,25537,142,37670,1696,26717,0,1,0,0,0
pkkid/python-plexapi,37,16838,927,11436,882,22187,73,32714,2,16611,9,4478,16,337,5,5,3,16103,64,28236,866,21850,0,1,0,0,0
cytomine/cytomine-python-client,28,5874,448,4128,8506,179361,735,257088,9,239090,46,44004,153,3054,14,14,5,17998,689,213084,8357,176307,0,1,0,0,0
barronh/pseudonetcdf,185,34137,1188,25191,26518,583125,1597,858123,10,722183,191,253291,1671,60543,22,22,12,135940,1406,604832,24886,522582,0,1,0,0,0
python-social-auth/social-core,200,13910,1014,7857,4554,67399,326,98547,7,61787,43,19301,207,4153,13,13,6,36760,283,79246,4348,63246,1,1,0,1,0
jrxfive/python-nomad,32,3707,306,2731,883,22268,73,32798,2,16611,8,4321,14,279,5,5,3,16187,65,28477,869,21989,0,1,0,0,0
konstantinstadler/pymrio,27,8635,143,7325,26018,474335,2166,1025293,9,521101,168,207142,1384,47708,27,27,18,504192,1998,818151,24670,426627,0,1,0,0,0
unioslo/zabbix-cli,0,0,0,0,883,22268,73,32798,0,0,0,0,0,0,5,5,5,32798,73,32798,883,22268,0,1,0,0,0
tableau/tabpy,50,5655,265,4318,52258,979303,2990,1386757,19,1014836,187,234433,1534,49344,55,55,36,371921,2803,1152324,50759,929959,1,1,0,1,0
tableau/server-client-python,122,18249,1195,12179,2295,34603,195,51619,4,22200,6,2015,15,247,8,8,4,29419,189,49604,2280,34356,0,1,0,0,0
sat-utils/sat-search,5,357,12,243,943,22550,74,33712,2,16611,9,4478,16,338,6,6,4,17101,65,29234,927,22212,0,1,0,0,0
opencobra/cobrapy,72,18887,474,14820,35212,649490,2088,1160271,17,909997,82,262233,435,11969,31,31,14,250274,2006,898038,34781,637521,0,0,0,0,1
jamielennox/requests-mock,12,1607,91,848,943,22550,74,33712,4,28985,20,8578,120,2533,6,6,2,4727,54,25134,824,20017,0,1,0,0,0
galkan/crowbar,11,900,33,746,3546,43615,182,62622,3,37071,34,15738,196,3609,6,6,3,25551,148,46884,3351,40006,1,0,0,1,0
maurosoria/dirsearch,68,5217,252,3028,6404,91608,353,172546,9,62290,36,23551,193,4297,21,21,12,110256,317,148995,6211,87311,0,2,0,0,0
conan-io/conan-package-tools,18,3337,198,2667,5985,87265,703,222822,8,61653,49,19168,246,4489,18,18,10,161169,654,203654,5743,82776,0,1,0,0,0
conan-io/conan,317,37810,2446,26880,2702,47235,165,67425,9,49957,39,22114,172,3123,14,14,5,17468,126,45311,2531,44112,0,1,0,0,0
nitmir/django-cas-server,22,5946,171,3193,10370,136603,999,198010,6,173976,110,53322,382,6683,12,12,6,24034,889,144688,10003,129920,0,1,0,0,0
searx/searx,188,22043,896,13617,6139,77795,342,119132,10,81659,53,35995,181,4659,16,16,6,37473,289,83137,5964,73136,2,1,0,2,0
cowrie/cowrie,157,23712,1042,16753,18503,227584,1020,367993,16,274379,189,133100,1042,16823,30,30,14,93614,831,234893,17484,210761,1,1,0,1,0
certtools/intelmq,321,32229,1003,18018,7028,105929,396,148582,9,129063,40,28623,281,5480,13,13,4,19519,356,119959,6747,100449,0,1,0,0,0
tethysplatform/tethys,217,34124,824,16135,6666,89581,385,139082,3,22571,22,10094,43,741,20,20,17,116511,363,128988,6623,88840,0,1,0,0,0
dj-stripe/dj-stripe,56,22650,467,6881,10347,135246,1119,200489,3,160842,146,62013,641,11370,10,10,7,39647,973,138476,9742,123876,0,1,0,0,0
pywbem/pywbem,61,62310,1572,48784,3153,52869,188,78132,9,70151,36,18470,257,5647,13,13,4,7981,152,59662,2898,47222,0,1,0,0,0
leancloud/python-sdk,30,5912,418,4082,8540,107923,529,175252,12,160831,82,54665,398,8305,18,18,6,14421,447,120587,8149,99618,1,1,1,0,0
abhishek-ram/pyas2-lib,7,1991,39,1498,3823,60058,217,88808,4,69688,45,34485,255,9425,6,6,2,19120,172,54323,3610,50633,0,0,0,0,1
getpatchwork/patchwork,118,15811,443,6401,4987,63596,264,89507,0,0,0,0,0,0,10,10,10,89507,264,89507,4987,63596,0,1,0,0,0
dlareau/puzzlehunt_server,100,7680,258,3136,25878,321058,2097,572670,7,145844,137,53994,505,7542,45,45,38,426826,1960,518676,25403,313516,2,1,1,1,0
openml/openml-python,40,14852,402,11961,22391,590502,1411,810823,16,805038,179,227602,1453,50576,19,19,3,5785,1232,583221,20974,539926,0,0,0,0,1
jpmens/mqttwarn,88,7268,194,5295,4112,62794,383,97476,7,86073,53,30865,350,6505,12,12,5,11403,330,66611,3773,56289,0,1,0,0,0
airbnb/knowledge-repo,107,11375,751,7196,44874,625805,2980,1086414,47,789199,326,235417,1755,41483,85,85,38,297215,2654,850997,43143,584322,3,0,0,2,1
threat9/routersploit,513,24110,749,11180,12513,170276,890,267485,7,151881,65,35001,262,4831,16,16,9,115604,825,232484,12257,165445,1,1,0,1,0
juniper/py-junos-eznc,84,17210,660,12925,8522,108932,461,159017,11,108401,63,44277,439,8000,19,19,8,50616,398,114740,8087,100932,0,1,0,0,0
juniper/jsnapy,17,7409,106,6910,11178,146236,778,217129,9,99192,22,12246,138,2301,24,24,15,117937,756,204883,11042,143935,0,1,0,0,0
nci-gdc/gdcdictionary,3,175,8,129,3758,58474,235,85493,2,12200,11,5099,23,289,15,15,13,73293,224,80394,3735,58185,0,1,0,0,0
hpcugent/vsc-base,26,7666,320,5074,1550,20605,81,31339,1,4932,1,1719,6,144,3,3,2,26407,80,29620,1544,20461,0,0,0,0,0
seisman/hinetpy,6,2956,51,2026,933,24213,78,35612,3,27987,20,7737,121,2627,6,6,3,7625,58,27875,814,21586,0,1,0,0,0
biosustain/cameo,74,16974,870,11172,82334,1438979,5291,2320453,30,1531914,210,358993,1159,34889,127,127,97,788539,5081,1961460,81193,1404090,0,2,0,0,0
sentinelsat/sentinelsat,9,2939,95,2314,1826,36981,146,53253,9,48526,47,17780,230,4708,11,11,2,4727,99,35473,1597,32273,0,1,0,0,0
gmplot/gmplot,27,2572,81,2132,882,22187,73,32714,2,16611,9,4478,16,337,5,5,3,16103,64,28236,866,21850,0,1,0,0,0
codecov/codecov-python,4,1312,15,1073,1531,33646,115,48089,2,16611,9,4478,17,351,7,7,5,31478,106,43611,1514,33295,0,1,0,0,0
lordfriend/albireo,97,6710,211,1847,24212,343085,1214,540777,18,389084,161,185994,898,21857,39,39,21,151693,1053,354783,23327,321228,1,1,0,1,0
codalab/codalab-worksheets,203,46382,1877,33969,60368,950799,4105,1544019,27,762156,180,138658,873,18485,87,87,60,781863,3925,1405361,59518,932314,1,4,1,0,1
nasa/apod-api,5,802,32,582,7161,112544,411,162228,9,102484,58,34761,227,5548,23,23,14,59744,353,127467,6935,106996,0,1,0,0,0
lxc/pylxd,50,6764,489,4501,3964,55764,235,82283,8,58436,28,12874,180,3806,12,12,4,23847,207,69409,3785,51958,1,1,0,1,0
mpib/lagerregal,172,11436,560,5298,21980,286880,1927,457108,14,318090,242,121977,1404,25622,35,35,21,139018,1685,335131,20623,261258,0,2,0,0,0
vida-nyu/reprozip,61,15126,568,11197,1398,29219,96,41696,6,25593,19,9936,88,1555,9,9,3,16103,77,31760,1313,27664,0,1,0,0,0
google/openhtf,71,23718,1003,11525,6891,95354,531,166978,4,12690,11,6024,26,570,23,23,19,154288,520,160954,6865,94784,0,2,0,0,0
diyan/pywinrm,11,1882,59,1430,3947,56159,214,84863,6,46449,25,9986,126,2678,12,12,6,38414,189,74877,3822,53481,1,1,0,1,0
sage-bionetworks/synapsepythonclient,50,21754,803,16765,4312,54126,239,80911,5,30947,24,9937,134,2941,16,16,11,49964,215,70974,4179,51185,0,2,0,0,0
planetlabs/planet-client-python,33,6675,298,4322,3312,49814,243,72267,11,60318,71,27240,482,8584,18,18,7,11949,172,45027,2833,41230,0,0,0,0,1
nrel/rdtools,14,7969,142,6133,52663,1411938,4341,1996201,14,1806097,218,336569,1750,80666,32,32,18,190104,4123,1659632,50956,1331272,0,1,0,0,0
nrel/openoa,28,7500,243,6217,42194,908683,3042,1371279,20,1161141,294,332952,2116,82317,39,39,19,210138,2748,1038327,40088,826366,0,1,0,0,0
docker/docker-py,69,14186,627,11289,5394,77784,299,113617,9,72656,65,30075,376,7349,15,15,6,40961,234,83542,5021,70435,2,1,1,1,0
wger-project/wger,383,38589,873,12010,18820,249294,1725,368421,18,280588,223,104507,1044,18583,36,36,18,87833,1502,263914,17837,230711,1,1,0,1,0
golemhq/golem,62,11859,786,8909,16019,203136,825,318612,14,224971,80,37693,273,5665,34,34,20,93641,745,280919,15749,197471,0,1,0,0,0
mixpanel/mixpanel-python,5,2229,126,1713,944,22631,74,33796,4,28985,20,8578,118,2578,6,6,2,4811,54,25218,826,20053,0,1,0,0,0
django-cas-ng/django-cas-ng,17,1057,32,634,10261,135017,1004,199133,2,150947,55,29794,187,3100,12,12,10,48186,949,169339,10082,131917,0,1,0,0,0
cookiecutter/cookiecutter,20,2431,73,1699,3203,55774,220,123892,11,106424,65,30714,247,4319,16,16,5,17468,155,93178,2959,51455,0,1,0,0,0
eliasgranderubio/dagda,50,4835,250,2900,7945,123985,489,176034,15,142700,118,61336,486,10502,21,21,6,33334,371,114698,7459,113483,3,0,1,2,1
gluster/gstatus,6,456,15,364,3774,46956,204,66856,2,23498,12,4846,52,832,7,7,5,43358,192,62010,3723,46124,0,1,0,0,0
mapillary/mapillary_tools,63,12483,488,9091,3506,58185,278,87570,11,49008,44,23465,182,3845,19,19,8,38562,234,64105,3326,54340,0,0,0,0,1
sasview/sasview,334,76015,3751,63078,35312,608621,2028,895971,13,696211,162,143266,966,30096,29,29,16,199760,1866,752705,34352,578525,0,1,0,0,0
regionmask/regionmask,21,4450,160,3006,18061,405743,1016,537906,15,475244,211,244864,1643,54459,30,30,15,62662,805,293042,16456,351284,0,1,0,0,0
scrapinghub/python-scrapinghub,29,4645,329,2912,1030,23671,79,35343,5,19240,13,6950,37,688,8,8,3,16103,66,28393,994,22983,0,1,0,0,0
scrapinghub/shub,38,4607,219,2702,8847,145769,719,254214,12,246381,80,30275,363,7805,15,15,3,7833,640,223939,8485,137964,0,1,0,0,0
yelp/pgctl,18,2495,162,1789,6046,71423,198,112686,4,112371,10,6989,68,1072,6,6,2,315,188,105697,5979,70351,1,0,0,1,0
cuemacro/findatapy,57,18094,500,12645,103002,1975596,7869,2986536,45,1966373,465,391886,2786,88755,139,139,94,1020163,7404,2594650,100255,1886841,0,3,0,0,0
holoviz/datashader,42,17956,986,13912,37548,747418,1849,1021556,15,935141,278,327725,2410,77256,31,31,16,86415,1571,693831,35193,670162,0,1,0,0,0
holoviz/holoviews,139,68078,2941,47149,21193,403012,1546,626940,17,548418,303,287059,1951,55764,37,37,20,78522,1243,339881,19295,347248,0,1,0,0,0
holoviz/geoviews,32,7195,275,4140,33732,607376,2246,979756,13,657225,217,225797,1378,42843,48,48,35,322531,2029,753959,32423,564533,0,1,0,0,0
oca/l10n-switzerland,77,2547,99,1419,3345,55715,503,133058,12,117587,62,26409,273,6389,17,17,5,15471,441,106649,3073,49326,0,0,0,0,1
kovacsbalu/wazeroutecalculator,6,809,54,664,882,22187,73,32714,2,16611,9,4478,16,337,5,5,3,16103,64,28236,866,21850,0,1,0,0,0
johnmaguire/cardinal,105,10000,605,7639,8313,107903,539,183908,0,0,0,0,0,0,22,22,22,183908,539,183908,8313,107903,0,3,0,0,0
edx/auth-backends,9,519,21,200,14670,183706,1455,272597,5,168312,54,19682,259,4756,20,20,15,104285,1401,252915,14412,178950,0,2,0,0,0
edx/repo-tools,68,8091,345,5395,4919,71098,308,101810,8,63292,61,28981,284,5460,17,17,9,38518,247,72829,4638,65638,0,1,0,0,0
edx/edx-drf-extensions,31,2080,91,1234,20608,268360,1770,395855,13,293516,100,39324,413,6695,30,30,17,102339,1670,356531,20200,261665,0,2,0,0,0
edx/xblock-lti-consumer,69,9248,256,5479,30194,402941,2540,603144,29,450034,240,108966,1253,24472,52,52,23,153110,2300,494178,28973,378469,0,1,0,0,0
edx/edx-proctoring,72,11511,358,7142,35233,438780,2778,663048,25,406110,176,73112,608,9921,62,62,37,256938,2602,589936,34645,428859,1,1,0,1,0
edx/edx-enterprise,603,57438,1597,28486,40588,535279,3222,809147,37,421150,267,115101,1218,21917,84,84,47,387997,2955,694046,39417,513362,0,2,0,0,0
edx/edx-search,17,1755,64,1135,27075,342427,2200,512257,5,186477,80,31162,320,5606,41,41,36,325780,2120,481095,26757,336821,0,1,0,0,0
minio/minio-py,26,9111,621,6748,408,7234,35,11300,2,11300,8,2815,16,381,2,2,0,0,27,8485,392,6853,0,0,0,0,1
elastic/rally,80,28414,1938,21470,23730,326201,1188,478556,5,41556,25,13954,139,2535,56,56,51,437000,1163,464602,23592,323666,0,1,0,0,1
elastic/elasticsearch-py,132,71569,1334,62389,639,9923,61,15978,2,15854,22,7649,68,1551,3,3,1,124,39,8329,584,8372,0,1,0,0,0
eternnoir/pytelegrambotapi,31,28660,1342,21010,882,22187,73,32714,4,28111,20,7688,117,2576,5,5,1,4603,53,25026,765,19611,0,0,0,0,1
nvbn/thefuck,213,6778,626,3919,14895,200134,1234,403917,1,27538,2,1369,31,472,48,48,47,376379,1232,402548,14864,199662,0,2,0,0,0
mwclient/mwclient,9,2715,121,2235,1390,32165,157,46926,3,7784,3,1430,6,49,8,8,5,39142,154,45496,1384,32116,0,1,0,0,0
rdmorganiser/rdmo,545,26368,939,7772,28002,339899,2700,509222,20,240800,193,77245,666,10310,66,66,46,268422,2507,431977,27387,329589,0,3,0,0,0
lbl-anp/becquerel,35,11810,401,9060,45478,828126,2510,1211693,21,1010865,236,280890,1744,60458,44,44,23,200828,2274,930803,43775,767668,0,1,0,0,0
punch-cyber/stoq,20,3468,83,1820,1374,30335,92,43822,4,23804,11,5819,26,640,8,8,4,20018,81,38003,1348,29695,0,1,0,0,0
mitmproxy/mitmproxy,238,44899,2129,23239,13636,190216,690,296533,21,154406,89,66031,571,12040,36,36,15,142127,601,230502,13077,178176,0,0,0,0,2
stripe/stripe-python,147,10154,503,5465,883,22268,73,32798,2,16611,8,4321,14,279,5,5,3,16187,65,28477,869,21989,0,1,0,0,0
iconfinder/pyvat,12,1160,41,624,2306,41119,145,60912,4,44809,12,5082,21,387,7,7,3,16103,133,55830,2285,40732,0,1,0,0,0
infoportugal/wagtail-modeltranslation,34,1491,69,1054,21056,263853,2312,408407,8,254294,127,65479,512,10008,33,33,25,154113,2185,342928,20558,253845,0,1,0,0,0
voxpupuli/puppetboard,24,2822,73,1870,7676,113328,456,170536,14,114438,55,31290,181,3591,29,29,15,56098,401,139246,7499,109737,1,1,0,1,0
voxpupuli/pypuppetdb,15,3184,146,1859,882,22187,73,32714,3,27987,20,7737,120,2627,5,5,2,4727,53,24977,762,19560,0,1,0,0,0
metaodi/osmapi,8,2664,86,2279,882,22187,73,32714,2,16611,8,4321,15,283,5,5,3,16103,65,28393,867,21904,0,1,0,0,0
vonage/vonage-python-sdk,25,2226,191,1388,4566,61257,233,92997,9,48875,34,18456,168,3752,15,15,6,44122,199,74541,4399,57505,0,2,0,0,0
xml-security/signxml,12,2239,74,1403,3133,34527,143,50483,4,31363,18,11895,94,1373,6,6,2,19120,125,38588,3042,33154,1,0,0,1,1
python273/vk_api,20,4931,183,3341,1058,25375,91,37404,3,27987,20,7737,119,2623,6,6,3,9417,71,29667,939,22752,0,1,0,0,0
sergeypirogov/webdriver_manager,29,1368,108,956,1455,29765,149,43322,5,25985,23,8819,104,2001,9,9,4,17337,126,34503,1351,27764,0,1,0,0,0
gallopsled/pwntools,178,68564,1667,29929,16122,227231,1356,495796,18,231038,123,70289,800,14087,30,30,12,264758,1233,425507,15329,213144,0,2,0,0,0
chaoss/grimoirelab-perceval,42,19537,876,13322,18128,241578,1237,458118,10,80127,51,33494,259,6636,37,37,27,377991,1186,424624,17870,234942,0,2,0,0,0
plivo/sharq-server,6,597,30,460,11049,114484,745,181398,11,152215,64,40048,320,6048,18,18,7,29183,681,141350,10736,108436,2,0,0,2,0
s4w3d0ff/python-poloniex,4,984,63,734,1026,24337,87,35820,4,31093,24,9362,164,3191,6,6,2,4727,63,26458,862,21146,0,1,0,0,0
dov-vlaanderen/pydov,49,9468,291,6724,12284,283746,705,378615,8,359324,155,175267,1290,41986,14,14,6,19291,550,203348,11029,241760,0,1,0,0,0
appium/python-client,311,16422,444,4693,10465,126224,532,207055,3,152115,28,9715,77,1340,14,14,11,54940,504,197340,10393,124884,0,1,0,0,0
pysmo/aimbat,22,7627,391,6108,25456,527716,1643,791051,7,612125,142,158202,959,30339,23,23,16,178926,1501,632849,24501,497377,0,1,0,0,0
zerodha/pykiteconnect,6,2064,101,1304,19387,235846,1095,382093,13,296250,86,61371,339,6210,26,26,13,85843,1009,320722,19053,229636,2,1,0,2,0
edcd/edmarketconnector,49,23039,624,17961,1407,26628,107,40469,5,35972,26,11873,149,3102,7,7,2,4497,81,28596,1260,23526,1,1,1,0,0
jamesoff/simplemonitor,45,7695,376,5767,30213,380848,1687,577152,20,382331,96,60417,619,12471,39,39,19,194821,1591,516735,29596,368377,0,2,0,0,0
napalm-automation-community/napalm-panos,4,1084,45,897,18644,272715,1400,394149,10,113010,22,12225,96,2543,42,42,32,281139,1378,381924,18553,270172,0,3,0,0,0
ankitects/anki,209,45429,3343,30792,2843,48459,188,72825,8,45659,35,17598,193,4165,15,15,7,27166,153,55227,2650,44294,0,1,0,0,0
bingads/bingads-python-sdk,187,20062,358,2446,15713,214681,1083,419648,4,59289,37,13411,142,2103,37,37,33,360359,1046,406237,15572,212578,0,1,0,0,0
nchammas/flintrock,15,4675,156,3678,6563,77460,342,112014,3,39435,22,9781,85,1006,13,13,10,72579,320,102233,6478,76454,0,1,0,0,0
bigcommerce/bigcommerce-api-python,31,1326,95,597,2881,47704,230,102504,3,18445,12,5001,21,412,12,12,9,84059,218,97503,2860,47292,1,1,0,1,0
getpopper/popper,26,3705,152,2782,6620,106481,680,178644,6,60810,42,15843,136,2851,24,24,18,117834,638,162801,6485,103630,1,1,0,1,0
moogar0880/pytrakt,11,3473,254,2483,1527,33659,164,48412,5,41201,25,9414,130,3089,9,9,4,7211,139,38998,1398,30570,0,1,0,0,0
chebpy/chebpy,19,2593,274,1560,7614,95795,295,150328,0,0,0,0,0,0,9,9,9,150328,295,150328,7614,95795,0,1,0,0,0
insarlab/mintpy,197,59240,1358,49106,45359,964863,3450,1501179,30,1068356,304,328808,1893,72112,73,73,43,432823,3146,1172371,43481,892751,0,2,0,0,0
oasis-open/cti-stix-validator,21,10729,238,5156,4806,69215,397,111015,14,70819,66,28372,276,6004,32,32,18,40196,331,82643,4533,63211,0,1,0,0,0
arm-doe/pyart,130,45280,740,30240,40703,836087,2285,1192465,19,935833,308,378530,2420,83230,58,58,39,256632,1977,813935,38325,752857,0,2,0,0,0
allankp/pytest-testrail,5,856,32,691,2879,48192,166,69599,3,45861,11,4959,21,433,11,11,8,23738,155,64640,2858,47759,0,1,0,0,0
glotaran/pyglotaran,132,17771,685,13353,36946,694527,2245,1060746,12,827070,216,265145,1833,61182,28,28,16,233676,2029,795601,35152,633345,0,1,0,0,0
wind-python/windpowerlib,21,4911,70,3577,10496,254970,588,339124,5,314380,130,160009,1121,37895,11,11,6,24744,458,179115,9409,217075,0,1,0,0,0
softlayer/softlayer-python,522,45683,1327,24623,5675,91250,691,242904,7,221945,103,48506,474,10674,13,13,6,20959,588,194398,5205,80576,0,1,0,0,0
galaxyproject/bioblend,64,14957,750,11750,4976,72104,433,112059,6,63669,17,9329,48,805,18,18,12,48390,416,102730,4928,71299,0,2,0,0,0
galaxyproject/planemo,160,20837,1190,13485,39082,677021,2789,1043770,24,232045,141,76793,851,17138,76,76,52,811725,2648,966977,38242,659883,0,2,0,0,0
pboardman/4scanner,0,0,0,0,882,22187,73,32714,0,0,0,0,0,0,5,5,5,32714,73,32714,882,22187,0,1,0,0,0
dominodatalab/python-domino,50,10186,480,5613,2138,41197,135,59782,8,48057,32,17019,181,4398,12,12,4,11725,103,42763,1958,36799,0,0,0,0,1
stellarcn/py-stellar-base,565,58405,4012,34924,4102,62917,223,90700,11,65476,28,18718,109,2732,19,19,8,25224,195,71982,3998,60185,1,1,0,1,0
mjg59/python-broadlink,15,2048,112,1302,2735,26491,117,39291,1,19173,9,4127,26,265,4,4,3,20118,108,35164,2709,26226,0,0,0,0,1
fffonion/xehentai,23,3840,197,2444,930,22931,75,33672,3,27987,24,9644,147,3329,6,6,3,5685,51,24028,783,19602,0,1,0,0,0
robotika/osgar,348,44194,2207,31473,7024,152759,527,218248,9,196947,92,78157,521,17828,14,14,5,21301,435,140091,6514,134931,1,1,1,0,0
panoptes/pocs,98,17907,872,13414,13116,181967,1037,304732,4,104908,30,17011,91,2161,30,30,26,199824,1007,287721,13032,179806,0,1,0,0,0
nabla-c0d3/sslyze,69,9857,244,5439,3750,41431,166,61841,6,42721,36,19147,193,3417,8,8,2,19120,130,42694,3563,38014,0,0,0,0,1
lucyparsons/openoversight,70,9477,402,5930,64911,864578,4311,1718421,35,915415,206,154454,1000,22561,99,99,64,803006,4105,1563967,63938,842017,1,1,1,0,0
yubico/yubikey-manager,56,16888,742,9522,4755,51082,324,81516,6,52607,54,23241,300,4288,13,13,7,28909,270,58275,4463,46794,1,0,0,1,0
juanifioren/django-oidc-provider,59,3801,127,1679,5472,80737,484,130754,1,56738,11,5205,51,977,8,8,7,74016,473,125549,5421,79760,0,1,0,0,0
zalando-stups/pierone-cli,11,1337,67,929,3226,53343,253,76660,9,45336,40,18538,233,4360,12,12,3,31324,213,58122,2993,48983,0,1,0,0,0
transtats/transtats,99,18834,697,11015,30257,363832,2506,594824,23,374180,183,81114,643,10901,61,61,38,220644,2323,513710,29639,352931,0,2,0,0,0
divio/divio-cli,23,5583,249,4109,3637,64766,257,91063,8,68227,32,21153,158,3793,14,14,6,22836,225,69910,3481,60973,0,1,0,0,0
librosa/librosa,38,29901,345,21536,28090,580398,1498,808138,14,759527,233,267053,1758,73901,24,24,10,48611,1265,541085,26339,506497,0,1,0,0,0
espressif/esptool,84,21339,957,15815,4503,49935,183,73622,7,54502,26,17396,196,3757,9,9,2,19120,157,56226,4308,46178,1,0,0,1,0
lablup/backend.ai-manager,184,36707,1218,24013,27781,366850,1648,560083,30,411653,212,189498,1117,25818,71,71,41,148430,1437,370585,26710,341032,2,0,1,1,0
securityinnovation/pgpy,18,9894,784,6033,3120,31589,138,48256,2,29136,32,13056,187,2387,4,4,2,19120,106,35200,2941,29202,1,0,0,1,0
caktus/aws-web-stacks,25,4622,10,138,12622,167846,1527,433638,2,88286,21,11177,126,1620,23,23,21,345352,1506,422461,12584,166226,0,1,0,0,0
cartodb/carto-python,26,3488,122,1861,3142,52610,324,82326,2,1692,5,1611,25,226,9,9,7,80634,319,80715,3123,52384,0,1,0,0,0
pndurette/gtts,16,1727,51,798,1416,30163,102,44340,4,38117,27,11278,128,2398,7,7,3,6223,75,33062,1288,27765,0,1,0,0,0
musculoskeletalatlasproject/mapclient,181,86037,1112,12725,10881,153357,802,255019,12,160667,53,39595,298,6168,24,24,12,94352,749,215424,10584,147189,0,1,0,0,0
radical-cybertools/radical.entk,24,5932,166,3920,13365,242189,784,369180,6,63630,76,37134,366,8240,18,18,12,305550,708,332046,13000,233949,0,0,0,0,1
erdc/rapidpy,31,9490,160,8267,12961,291180,866,395783,12,378490,145,177254,1197,41943,18,18,6,17293,721,218529,11795,249237,0,1,0,0,0
wagtail/wagtailtrans,37,1716,80,912,22391,276013,2478,461408,7,207439,115,52856,442,7360,32,32,25,253969,2363,408552,21973,268653,1,1,0,1,0
wagtail/wagtail,796,92553,5113,56843,15823,205605,1515,314642,23,285583,327,122805,1463,23231,31,31,8,29059,1188,191837,14446,182374,0,1,0,0,0
onaio/onadata,464,56370,1888,33140,52669,713271,4510,1186171,51,601646,454,206751,2258,43276,119,119,68,584525,4056,979420,50490,669995,1,1,0,1,0
stamusnetworks/scirius,215,29290,925,15631,19345,247706,2047,488690,20,363830,239,115272,1076,18173,42,42,22,124860,1808,373418,18325,229533,0,1,0,0,0
yeatmanlab/pyafq,51,17046,474,13805,49461,1029000,2952,1424035,34,1225757,383,443611,2863,90620,59,59,25,198278,2569,980424,46642,938380,0,1,0,0,0
missionpinball/mpf-mc,114,15961,907,11056,13209,175962,1137,373619,4,268577,127,70637,710,10482,17,17,13,105042,1010,302982,12513,165480,1,1,0,0,0
aio-libs/aiobotocore,31,6030,281,4858,5265,73609,247,106125,13,98318,76,50662,716,10141,17,17,4,7807,171,55463,4591,63468,1,0,0,1,0
aio-libs/sockjs,18,1559,74,1010,1870,30956,96,44196,7,34134,17,8790,99,1926,9,9,2,10062,79,35406,1778,29030,1,0,1,0,0
aio-libs/aiodocker,24,3125,196,2297,2032,32643,97,47268,6,39461,23,16748,152,3393,10,10,4,7807,74,30520,1885,29250,1,0,0,1,0
aio-libs/aiohttp-session,12,992,70,629,1870,30956,96,44196,6,33887,13,6518,60,1257,9,9,3,10309,83,37678,1814,29699,1,0,1,0,0
aio-libs/aiohttp-sse,3,296,27,170,1870,30956,96,44196,2,20962,3,1792,7,90,9,9,7,23234,93,42404,1864,30866,1,0,0,1,0
aio-libs/aiohttp-devtools,13,1370,73,930,4354,62370,490,188447,14,178451,65,36957,274,5871,19,19,5,9996,425,151490,4087,56499,1,0,1,0,0
geoscienceaustralia/eo-datasets,32,14812,479,10432,53651,987391,2695,1357157,27,986633,258,256984,1702,54303,68,68,41,370524,2437,1100173,51992,933088,0,1,0,0,0
geoscienceaustralia/pyrate,51,13701,447,9072,911,14715,143,26841,0,0,0,0,0,0,3,3,3,26841,143,26841,911,14715,0,0,0,0,0
georgetown-ir-lab/quickumls,11,1679,69,1207,23907,383545,1572,629680,5,340258,23,26186,219,4446,39,39,34,289422,1549,603494,23688,379099,0,1,0,0,0
log2timeline/plaso,470,103851,2920,70260,20267,314334,1671,496268,23,245514,183,93278,980,20674,68,68,45,250754,1488,402990,19303,293660,0,2,0,0,0
log2timeline/dfvfs,319,32712,1428,24645,9732,139896,679,247667,4,35829,24,11414,63,1198,32,32,28,211838,655,236253,9671,138698,1,0,0,1,0
qcodes/qcodes,428,87004,3357,63912,53253,887911,3888,1472270,25,694356,256,294293,1898,61473,94,94,69,777914,3632,1177977,51402,826438,0,2,0,0,0
moonso/genmod,60,7050,120,5126,3045,44688,153,62623,7,23004,19,13134,94,2246,16,16,9,39619,134,49489,2952,42442,1,0,0,1,0
sharppy/sharppy,76,29113,1097,24286,1246,28450,92,41328,5,25349,12,7197,46,1224,7,7,2,15979,80,34131,1200,27226,0,0,0,0,1
farrokhi/dnsdiag,8,1388,27,1005,2524,43051,241,63428,5,47325,18,10519,79,1836,8,8,3,16103,223,52909,2446,41215,0,1,0,0,0
wheatoncs/lexos,64,10385,408,8142,58611,1419833,5624,2228034,16,1523001,128,169360,606,28769,71,71,55,705033,5496,2058674,58009,1391064,0,2,0,0,0
nordicsemiconductor/pc-ble-driver-py,12,5126,391,3370,2674,26330,110,38674,2,19554,8,4556,35,501,4,4,2,19120,102,34118,2641,25829,1,0,0,1,0
nordicsemiconductor/pc-nrfutil,41,9170,346,4882,7031,79162,347,130517,12,73471,59,33641,358,6098,17,17,5,57046,288,96876,6680,73064,0,1,0,0,0
frictionlessdata/frictionless-py,336,25713,1108,13186,8817,140088,1245,349387,11,70135,52,26789,237,6955,38,38,27,279252,1193,322598,8581,133133,0,1,0,0,0
frictionlessdata/datapackage-py,15,2845,132,2161,18380,263713,943,444691,11,93929,64,19344,260,5026,35,35,24,350762,879,425347,18121,258687,0,1,0,0,0
f5networks/f5-common-python,308,31824,1808,15168,974,23247,79,34751,3,7472,6,2892,10,124,7,7,4,27279,73,31859,966,23123,0,1,0,0,0
f5networks/f5-openstack-agent,50,16011,738,12367,2494,36204,357,62113,2,28276,14,5857,50,611,8,8,6,33837,343,56256,2444,35593,0,1,0,0,0
optimizely/python-sdk,54,10538,369,7635,4625,63457,250,93021,3,21258,11,6293,21,549,16,16,13,71763,239,86728,4604,62908,0,2,0,0,0
okpy/ok-client,74,8406,472,6086,9425,120151,538,181567,5,52751,33,12701,251,3882,23,23,18,128816,505,168866,9175,116269,1,2,1,0,0
alessandroz/lazagne,247,33751,1356,20009,6666,75359,355,118917,6,89781,36,19615,202,2852,8,8,2,29136,319,99302,6464,72507,0,1,0,0,0
aws-quickstart/taskcat,57,7856,389,5378,34751,613510,2562,1058316,16,179297,88,58480,662,12161,38,38,22,879019,2474,999836,34089,601349,0,1,0,0,0
fishtown-analytics/dbt,199,52533,3473,31542,14119,255251,1114,348934,26,267143,130,58239,383,8940,45,45,19,81791,984,290695,13769,246311,0,1,0,0,0
playpauseandstop/rororo,21,3806,120,2100,7847,106131,648,157103,18,97705,53,24423,172,3254,29,29,11,59398,595,132680,7685,102877,1,0,0,1,0
hyphaapp/hypha,854,53259,2165,20053,16579,277938,1075,390827,3,26741,17,11275,70,1253,40,40,37,364086,1058,379552,16509,276685,0,1,0,0,0
mozilla-services/kinto-dist,19,2501,87,2025,32459,480155,2279,725922,9,102568,35,19464,109,1905,68,68,59,623354,2244,706458,32359,478250,0,1,0,0,0
torchbox/wagtailmedia,30,2002,86,952,20872,261599,2294,405308,13,304717,178,82803,580,10310,32,32,19,100591,2116,322505,20319,251289,0,1,0,0,0
httpie/http-prompt,17,1969,134,1041,14401,218449,1401,474008,14,274566,165,63274,1010,17696,23,23,9,199442,1236,410734,13398,200753,0,1,0,0,0
httpie/httpie,86,10742,500,6168,10525,168601,1127,395447,10,209054,93,39831,445,10096,15,15,5,186393,1034,355616,10086,158505,0,1,0,0,0
spyder-ide/spyder-notebook,22,2614,111,1714,57631,792860,4203,1338550,24,438059,93,57943,367,8578,162,162,138,900491,4110,1280607,57271,784282,0,2,0,0,0
auhau/toggl-cli,20,5318,264,3182,5423,89343,442,134908,19,117075,64,32674,262,5801,26,26,7,17833,378,102234,5162,83542,0,1,0,0,0
zalando/connexion,52,8551,565,5826,4939,78843,282,114367,12,91945,51,38014,155,3150,22,22,10,22422,231,76353,4786,75693,0,1,0,0,0
altschool/dynamic-rest,40,5792,267,4189,10645,130978,1042,191313,5,149030,98,42811,370,6164,13,13,8,42283,944,148502,10286,124814,0,1,0,0,0
pimutils/khal,30,11063,587,8219,2678,40231,108,56318,10,51922,46,38596,461,10758,11,11,1,4396,62,17722,2229,29473,1,0,0,1,0
auth0/auth0-python,61,7748,428,5679,3476,48437,190,71666,4,36443,20,9545,60,1051,9,9,5,35223,170,62121,3416,47386,1,1,0,1,0
unidata/siphon,27,8408,304,4719,11779,273162,652,367110,7,332702,139,168678,1254,41746,14,14,7,34408,513,198432,10560,231416,0,1,0,0,0
unidata/metpy,68,36262,897,26735,33128,723223,1935,1046416,19,903171,286,351523,2378,83595,30,30,11,143245,1649,694893,30799,639628,0,1,0,0,0
epistasislab/tpot,37,7474,147,4629,22331,593533,1432,812308,9,756034,295,348924,2552,95982,19,19,10,56274,1137,463384,19822,497551,0,1,0,0,0
jupyter-incubator/sparkmagic,78,6247,360,3889,49330,1031630,4536,1567276,17,1057728,100,99436,499,12984,105,105,88,509548,4436,1467840,48854,1018646,0,2,0,0,0
byt3bl33d3r/crackmapexec,115,16074,549,11199,34997,483337,3058,954841,33,503778,322,167323,2061,39726,69,69,36,451063,2736,787518,32976,443611,1,1,0,1,0
mailpile/mailpile,158,54346,522,6809,8552,120345,481,178175,9,75668,21,9852,58,683,20,20,11,102507,460,168323,8495,119662,1,0,0,1,0
twisted/axiom,27,10727,686,6880,16606,193618,923,321497,3,10066,15,3492,27,266,20,20,17,311431,908,318005,16580,193352,0,1,0,0,0
twisted/treq,11,2178,110,1523,16876,202887,930,333767,9,225061,52,37513,232,4184,22,22,13,108706,878,296254,16650,198703,0,2,0,0,0
dictation-toolbox/caster,350,22712,1061,9918,3892,60303,256,92024,1,27538,6,1968,47,682,14,14,13,64486,250,90056,3845,59621,0,1,0,0,0
grow/grow,283,32134,2171,23997,13508,191715,1163,396365,27,293072,134,80900,640,12621,47,47,20,103293,1029,315465,12879,179094,3,1,0,2,0
cloudant/python-cloudant,20,7397,294,5338,882,22187,73,32714,3,27987,20,7737,120,2634,5,5,2,4727,53,24977,762,19553,0,1,0,0,0
counterpartyxcp/counterblock,28,6944,250,5807,12179,158765,560,238333,8,54755,21,14275,108,3118,22,22,14,183578,539,224058,12072,155647,1,2,0,0,0
undergreen/ansible-role-mongodb,1,503,8,289,14945,216223,1334,457407,0,0,0,0,0,0,52,52,52,457407,1334,457407,14945,216223,0,2,0,0,0
vanheeringen-lab/gimmemotifs,73,20686,547,16579,66866,1320298,3869,1949370,31,1443082,402,452534,3355,124598,61,61,30,506288,3467,1496836,63558,1195700,0,1,0,0,0
vanheeringen-lab/genomepy,34,6793,275,5322,20974,449123,1286,645777,17,562001,178,187963,1402,45739,28,28,11,83776,1108,457814,19609,403384,0,1,0,0,0
instana/python-sensor,129,11267,477,7568,2233,36764,198,57551,8,36744,34,13163,164,3308,12,12,4,20807,164,44388,2074,33456,0,1,0,0,0
qiniu/python-sdk,36,5842,417,4493,882,22187,73,32714,2,16611,13,6018,67,1440,5,5,3,16103,60,26696,815,20747,0,1,0,0,0
bird-house/flyingpigeon,36,6499,123,4846,23118,391748,1064,590772,11,258926,95,83761,457,12717,40,40,29,331846,969,507011,22662,379031,0,1,0,0,0
ably/ably-python,44,5477,487,3825,2869,45114,206,71100,12,45010,76,26780,449,8054,17,17,5,26090,130,44320,2422,37060,0,0,0,0,1
furlongm/patchman,81,6070,199,3056,11843,145114,1184,249121,12,181509,122,53409,467,7809,22,22,10,67612,1062,195712,11394,137305,1,1,0,1,1
tuw-geo/ascat,18,8138,232,6787,10637,252132,600,333419,6,156363,37,46042,161,6380,17,17,11,177056,563,287377,10476,245752,0,1,0,0,0
rallytools/rallyresttoolkitforpython,15,6347,182,4806,1110,27089,84,39257,4,28985,21,8735,121,2633,7,7,3,10272,63,30522,989,24456,0,1,0,0,0
kklmn/xrt,40,23097,236,6920,30551,586541,2083,996374,8,658150,66,72554,290,10471,35,35,27,338224,2017,923820,30262,576070,0,1,0,0,0
alisw/alibuild,16,3837,135,3230,5567,82261,280,115859,8,89107,51,29374,216,3491,15,15,7,26752,229,86485,5353,78770,0,1,0,0,0
offu/werobot,34,4154,256,2789,900,22647,74,33258,3,17155,12,6197,23,639,6,6,3,16103,62,27061,877,22008,0,1,0,0,0
wikimedia/revscoring,173,21863,650,8784,24869,485992,1347,684818,17,538131,91,85056,467,13172,33,33,16,146687,1256,599762,24403,472820,0,2,0,0,0
ledatelescope/bifrost,91,14967,871,9451,9483,134465,576,203235,2,35154,5,3440,41,800,33,33,31,168081,571,199795,9442,133665,0,2,0,0,0
robotframework/sshlibrary,22,5116,328,3635,7958,75321,417,115279,3,71921,105,30995,670,7050,8,8,5,43358,312,84284,7289,68271,0,1,0,0,0
robotframework/seleniumlibrary,56,8696,467,6124,14822,156799,766,258278,2,180445,110,27681,624,5465,16,16,14,77833,656,230597,14201,151334,0,1,0,0,0
stevenblack/hosts,4,4227,189,3575,915,22441,74,33061,2,16611,10,5512,18,390,6,6,4,16450,64,27549,897,22051,0,1,0,0,0
python-telegram-bot/python-telegram-bot,178,58048,1384,33529,1780,27706,124,39980,7,38974,49,18912,341,5718,8,8,1,1006,75,21068,1440,21988,0,0,0,0,1
lneuhaus/pyrpl,77,22097,1266,13582,24567,529282,1528,711438,9,638986,227,248171,1801,57596,20,20,11,72452,1301,463267,22803,471686,0,1,0,0,0
rmcgibbo/sphinxcontrib-autodoc_doxygen,7,889,53,715,10774,148268,825,325606,6,146462,27,18279,73,1097,25,25,19,179144,798,307327,10715,147171,0,1,0,0,0
easypost/easypost-python,92,3072,203,1788,1045,23955,74,35870,2,16611,10,4793,18,353,6,6,4,19259,64,31077,1027,23602,0,1,0,0,0
flask-middleware/flask-security,35,12604,501,8535,5154,73288,288,112142,12,92142,46,30727,210,3955,18,18,6,20000,242,81415,4958,69333,0,0,0,0,0
fedora-infra/anitya,107,13826,412,9304,36730,480792,2020,742309,33,520196,170,162502,797,19642,69,69,36,222113,1850,579807,35952,461150,0,2,0,0,0
fedora-infra/the-new-hotness,55,4587,106,2607,22301,279313,1183,437665,14,267494,58,38332,264,5441,44,44,30,170171,1125,399333,22039,273872,0,2,0,0,0
jupyterhub/batchspawner,6,1147,47,500,21859,318629,912,469649,7,87147,27,26495,99,2797,37,37,30,382502,885,443154,21772,315832,0,2,0,0,0
inmanta/inmanta-core,160,59806,3781,39612,17915,264058,1212,470700,32,212520,149,83807,885,18451,47,47,15,258180,1063,386893,17034,245607,1,1,0,1,0
pslmodels/tax-calculator,33,12216,238,10333,2012,40539,122,63863,0,0,0,0,0,0,11,11,11,63863,122,63863,2012,40539,0,1,0,0,0
pslmodels/og-core,22,14526,171,13471,44400,885981,2692,1328913,21,955895,274,315143,2142,71978,47,47,26,373018,2418,1013770,42299,814003,0,1,0,0,0
lowerquality/gentle,21,1676,107,1170,4567,60062,277,84410,0,0,0,0,0,0,11,11,11,84410,277,84410,4567,60062,0,1,0,0,0
googleads/googleads-python-lib,7,2823,113,1883,4937,80899,603,144772,7,45078,30,14931,117,1994,24,24,17,99694,573,129841,4820,78905,0,1,0,0,0
naomiproject/naomi,252,32025,1052,25997,3419,54968,219,81635,12,73660,49,19357,266,5551,15,15,3,7975,170,62278,3154,49417,0,1,0,0,0
tardis-sn/tardis,126,32509,926,25563,2402,45315,174,67432,2,16611,9,4478,16,337,16,16,14,50821,165,62954,2386,44978,0,1,0,0,0
piqueserver/piqueserver,110,18508,1213,12161,24690,302217,1224,502603,14,381166,163,148097,1169,18665,30,30,16,121437,1061,354506,23529,283552,2,0,1,1,0
googlefonts/pyfontaine,418,220348,499,215447,5894,94517,395,154634,4,135360,11,5968,21,424,9,9,5,19274,384,148666,5873,94093,0,1,0,0,0
jag1g13/pycgtool,12,2633,119,2155,14195,345327,1216,582928,3,182961,44,49961,182,7546,13,13,10,399967,1172,532967,14014,337781,0,0,0,0,0
thetisproject/thetis,49,23919,842,15503,11160,303105,757,413252,6,411965,49,61827,256,9747,9,9,3,1287,708,351425,10906,293358,0,1,0,0,0
razorpay/razorpay-python,30,1926,163,1456,882,22187,73,32714,2,16611,8,4321,14,279,5,5,3,16103,65,28393,868,21908,0,1,0,0,0
brickschema/brick,27,12764,30,924,61040,1148331,3879,1706847,14,254205,119,59567,612,15281,103,103,89,1452642,3760,1647280,60437,1133050,0,1,0,0,0
econforge/dolo.py,61,12146,467,8193,62688,1099674,3829,1862062,15,997842,164,172353,907,29887,56,56,41,864220,3665,1689709,61790,1069787,0,1,0,0,0
matrix-org/matrix-python-sdk,18,3304,182,2456,1113,24717,91,36175,3,28463,14,6773,45,858,6,6,3,7712,77,29402,1068,23859,0,1,0,0,0
matrix-org/synapse,548,198753,6023,150958,21372,283987,1620,535082,11,78790,51,31820,313,7927,70,70,59,456292,1569,503262,21059,276060,0,2,0,0,1
dallinger/dallinger,87,20991,1208,15210,62558,855438,4404,1716279,44,1249413,293,216331,1429,30456,90,90,46,466866,4111,1499948,61170,824982,0,2,0,0,0
iqtlabs/poseidon,43,5706,308,4561,4489,66661,256,96493,0,0,0,0,0,0,11,11,11,96493,256,96493,4489,66661,0,2,0,0,0
matlink/gplaycli,6,818,25,654,5836,84089,310,139486,6,60350,29,14539,161,2878,14,14,8,79136,281,124947,5676,81211,1,1,0,1,0
georgemarshall/django-cryptography,9,898,63,534,11466,132657,1009,194809,4,168756,63,23467,275,4012,8,8,4,26053,946,171342,11207,128645,1,0,0,1,0
modoboa/modoboa,428,33671,1457,17832,21781,267576,1911,442121,21,410137,295,128317,1223,22151,24,24,3,31984,1616,313804,20636,245425,1,0,0,1,0
pipoline/rocket-python,34,1021,87,618,4428,70414,256,99648,2,16611,9,4478,16,338,23,23,21,83037,247,95170,4412,70076,0,1,0,0,0
archesproject/arches,376,55860,1722,31226,39549,590164,3074,855852,39,692739,330,151428,1613,31941,69,69,30,163113,2744,704424,37983,558223,1,2,0,1,0
simple-salesforce/simple-salesforce,11,2753,105,2214,5223,71347,363,106915,6,42070,25,14316,99,1680,18,18,12,64845,338,92599,5125,69667,0,2,0,0,0
uploadcare/pyuploadcare,55,6042,314,3858,4554,65428,328,97178,9,45053,49,20339,295,5472,16,16,7,52125,279,76839,4259,59956,0,0,0,0,1
tribler/tribler,362,43597,2636,30515,18946,346083,1333,525658,12,369694,90,56888,533,9211,35,35,23,155964,1243,468770,18419,336872,0,1,0,0,1
cta-observatory/ctapipe,130,33840,1096,22864,60241,1097705,3448,1639135,32,1367139,317,348244,1970,68107,50,50,18,271996,3131,1290891,58304,1029598,0,0,0,0,1
alex-rudakov/sphinx-argparse,5,1138,39,989,10250,141371,794,315332,4,227012,12,8981,78,864,23,23,19,88320,782,306351,10201,140507,0,1,0,0,0
pybel/pybel,183,27309,1236,15205,27021,558526,1441,765678,18,709921,259,341276,1998,60560,35,35,17,55757,1182,424402,25061,497966,0,1,0,0,0
ahmadfaizalbh/chatbot,8,1538,119,1233,883,22268,73,32798,0,0,0,0,0,0,5,5,5,32798,73,32798,883,22268,0,1,0,0,0
jjjake/internetarchive,28,6878,180,5076,1348,27874,128,41033,9,36306,26,11231,191,3623,11,11,2,4727,102,29802,1162,24251,0,1,0,0,0
infobyte/faraday,169,22696,919,13199,13180,181674,591,273024,10,80237,53,36009,203,4546,33,33,23,192787,538,237015,12981,177128,0,2,0,0,0
pylast/pylast,1,2918,235,2293,1780,27706,124,39980,5,29619,36,12722,282,5001,8,8,3,10361,88,27258,1498,22705,0,0,0,0,1
common-workflow-language/cwltool,53,17493,494,14238,12453,277948,839,369317,16,196878,64,77140,422,9348,33,33,17,172439,775,292177,12035,268600,0,1,0,0,0
common-workflow-language/cwltest,10,1667,44,1233,7127,110603,424,165219,8,104866,29,18230,150,3690,25,25,17,60353,395,146989,6982,106913,0,1,0,0,0
common-workflow-language/schema_salad,55,18381,614,14909,4445,69457,293,108853,6,72775,36,17045,186,3590,15,15,9,36078,257,91808,4262,65867,0,1,0,0,0
sdss/marvin,121,37421,1472,26749,57738,1153275,3798,1764751,38,1441106,467,577322,3242,105286,63,63,25,323645,3331,1187429,54550,1047989,1,0,0,1,1
okigan/awscurl,5,626,19,499,3823,54347,190,78987,3,18146,11,6098,17,337,12,12,9,60841,179,72889,3807,54010,0,2,0,0,0
turbo87/utm,5,359,10,266,8460,107228,328,166806,0,0,0,0,0,0,12,12,12,166806,328,166806,8460,107228,0,1,0,0,0
opendronemap/odm,120,19807,695,16036,7346,108446,715,190123,5,37572,20,12472,46,1205,26,26,21,152551,695,177651,7300,107241,0,2,0,0,0
zach-taylor/splunk_handler,2,381,17,304,899,22491,74,33066,3,27987,19,7580,116,2555,6,6,3,5079,55,25486,783,19936,0,1,0,0,0
browniebroke/deezer-python,21,2058,134,1221,882,22187,73,32714,2,16611,8,4321,14,279,5,5,3,16103,65,28393,868,21908,0,1,0,0,0
pv8/noipy,6,582,28,299,882,22187,73,32714,2,16611,9,4478,16,337,5,5,3,16103,64,28236,866,21850,0,1,0,0,0
zhmcclient/python-zhmcclient,55,35050,982,26384,2987,50422,229,73678,10,44004,27,17618,66,1234,21,21,11,29674,202,56060,2921,49188,0,1,0,0,0
gridsync/gridsync,81,15375,735,10034,22705,277568,1307,440619,13,113495,67,39250,212,5767,34,34,21,327124,1240,401369,22495,271801,0,1,0,0,1
mroberge/hydrofunctions,11,2861,46,2225,29646,536258,2027,911432,12,554147,162,194965,1344,46842,41,41,29,357285,1865,716467,28336,489416,0,1,0,0,0
fpgawars/apio,33,4844,196,3410,6136,95331,445,141864,6,35781,24,11394,91,1722,12,12,6,106083,421,130470,6046,93609,1,1,0,1,0
altdesktop/i3ipc-python,15,2722,132,1595,15354,208616,1096,423036,0,0,0,0,0,0,44,44,44,423036,1096,423036,15354,208616,0,1,0,0,0
googlemaps/google-maps-services-python,17,2983,73,2211,882,22187,73,32714,2,16611,9,4462,16,309,5,5,3,16103,64,28252,866,21878,0,1,0,0,0
thenetcircle/dino,168,29637,2135,19817,10496,254970,588,339124,6,189009,16,11622,59,1518,11,11,5,150115,572,327502,10438,253452,0,1,0,0,0
ndokter/dsmr_parser,19,2152,93,1024,4710,59747,265,93144,5,22582,16,8788,89,1862,13,13,8,70562,249,84356,4623,57885,0,1,0,0,0
yeti-platform/yeti,214,17125,739,11012,2217,35574,114,50119,0,0,0,0,0,0,10,10,10,50119,114,50119,2217,35574,0,1,0,0,0
uberi/speech_recognition,7,2055,58,1761,882,22187,73,32714,2,16611,9,4478,17,350,5,5,3,16103,64,28236,865,21837,0,1,0,0,0
deniscarriere/geocoder,67,8672,897,4271,3319,53921,317,84697,5,67145,33,20510,107,1538,10,10,5,17552,284,64187,3214,52383,0,1,0,0,0
kinto/kinto-signer,17,2238,72,1837,12217,165964,713,243233,12,119856,44,28486,176,3032,48,48,36,123377,669,214747,12046,162932,0,1,0,0,0
kinto/kinto,83,15629,820,11743,7220,104631,451,157015,18,107689,90,48605,381,8003,39,39,21,49326,361,108410,6857,96628,0,1,0,0,0
svenevs/exhale,23,11127,193,8170,13266,166407,872,350141,4,192906,33,17721,106,2692,28,28,24,157235,839,332420,13162,163715,0,1,0,0,0
fleet-commander/fc-client,24,2889,122,1715,20028,248526,1198,381702,0,0,0,0,0,0,47,47,47,381702,1198,381702,20028,248526,0,4,0,0,0
maxmind/geoip2-python,9,2467,73,804,2557,42582,157,61791,8,56685,34,19025,166,3732,13,13,5,5106,123,42766,2397,38850,1,1,0,1,0
algolia/algoliasearch-client-python,33,3362,274,2550,10079,140963,585,233725,4,55525,20,7822,115,2381,21,21,17,178200,565,225903,9964,138582,0,1,0,0,0
algolia/algoliasearch-django,14,1050,56,718,10121,132375,1006,193950,3,154303,28,6184,56,915,10,10,7,39647,978,187766,10065,131460,0,1,0,0,0
radish-bdd/radish,43,5411,259,3903,10465,126224,535,207266,0,0,0,0,0,0,15,15,15,207266,535,207266,10465,126224,0,1,0,0,0
pysat/pysat,37,18530,289,15783,26010,605478,1413,797271,11,764415,259,306648,2347,77911,28,28,17,32856,1154,490623,23701,527567,0,1,0,0,0
ultimaker/uranium,232,39528,2487,30306,8621,137909,706,250687,0,0,0,0,0,0,10,10,10,250687,706,250687,8621,137909,0,3,0,0,0
getslash/backslash,178,9567,828,5140,2744,44706,190,66124,4,27008,14,8709,36,464,12,12,8,39116,176,57415,2709,44242,0,1,0,0,0
namaggarwal/splitwise,19,2794,191,2157,1330,31883,156,46012,5,41201,23,8496,87,1794,7,7,2,4811,133,37516,1243,30089,0,1,0,0,0
signalfx/signalfx-python,21,3473,254,1999,2090,36597,177,55694,5,33985,41,12439,195,3881,9,9,4,21709,136,43255,1895,32716,0,1,0,0,0
thekevjames/coveralls-python,15,991,44,743,1531,32187,130,46545,4,30358,25,11843,146,2324,7,7,3,16187,105,34702,1385,29863,0,1,0,0,0
closeio/tasktiger,22,4437,163,3294,2379,32319,100,43655,3,43408,9,10131,26,587,4,4,1,247,91,33524,2353,31732,1,0,0,1,0
oggm/oggm,42,30130,688,26862,30039,672582,1773,974810,13,830638,253,318058,2049,73311,27,27,14,144172,1520,656752,28033,599271,1,1,0,1,0
mendix/cf-mendix-buildpack,68,12308,684,9179,6909,90214,357,132482,13,97016,64,31807,319,5927,18,18,5,35466,293,100675,6593,84287,1,0,0,1,2
ojarva/python-sshpubkeys,4,660,33,385,3059,31344,140,46041,2,20162,13,6719,49,414,5,5,3,25879,127,39322,3019,30930,0,0,0,0,1
getstream/stream-django,15,612,61,335,11863,154145,1091,226236,6,173246,46,16677,109,1819,19,19,13,52990,1045,209559,11755,152326,0,2,0,0,0
jonathonreinhart/scuba,14,1739,91,1278,20218,287831,1289,511968,5,61427,36,19070,206,4627,47,47,42,450541,1253,492898,20013,283204,0,1,0,0,0
miserlou/zappa,18,8782,251,7506,13463,203363,1215,399007,16,193902,77,45454,390,8890,26,26,10,205105,1138,353553,13083,194473,0,1,0,0,0
christabor/flask_jsondash,21,2759,100,1556,5854,74308,277,107006,6,92363,52,27446,200,4162,9,9,3,14643,225,79560,5655,70146,1,0,0,1,0
the-useless-one/pywerview,17,4203,144,3466,20326,256157,1331,486638,11,298790,119,78152,778,15753,28,28,17,187848,1212,408486,19563,240404,1,0,0,1,0
cloudinary/pycloudinary,55,6980,409,4946,524,7713,43,12774,3,12774,21,8460,106,2382,3,3,0,0,22,4314,418,5331,0,0,0,0,1
pnuckowski/aioresponses,4,634,40,476,1870,30956,96,44196,3,22379,9,5275,31,547,9,9,6,21817,87,38921,1845,30409,1,0,0,1,0
jpush/jpush-api-python-client,16,1312,98,793,882,22187,73,32714,2,16611,8,4321,14,279,5,5,3,16103,65,28393,868,21908,0,1,0,0,0
peopledoc/django-agnocomplete,29,2986,153,1230,9908,130188,975,191592,2,150947,79,34258,311,5628,10,10,8,40645,896,157334,9608,124560,0,1,0,0,0
sdispater/orator,142,22907,1717,18447,3861,48407,874,222324,13,160322,77,30055,278,5727,20,20,7,62002,798,192269,3586,42680,1,0,1,0,0
pdfminer/pdfminer.six,40,21113,666,8567,2614,27103,117,41362,2,22242,15,5683,52,1447,4,4,2,19120,102,35679,2562,25656,1,0,0,1,0
sulab/wikidataintegrator,20,20770,434,8892,20317,376445,1400,563312,22,475798,298,205193,2037,49313,44,44,22,87514,1102,358119,18317,327132,0,1,0,0,0
cubewise-code/tm1py,91,28387,1891,23456,1405,26037,97,39316,6,34589,26,12690,231,3749,8,8,2,4727,71,26626,1174,22288,0,1,0,0,0
alerta/alerta,108,16332,1005,11474,1751,34475,107,51567,6,40485,34,16102,201,3978,11,11,5,11082,73,35465,1550,30497,0,1,0,0,0
pycqa/isort,50,10144,243,6570,12682,191581,857,325698,2,38400,3,4631,26,470,23,23,21,287298,854,321067,12656,191111,0,1,0,0,0
pydata/pandas-datareader,50,9497,349,6062,10828,259461,616,346234,8,340482,140,167974,1253,42454,12,12,4,5752,476,178260,9609,217007,0,1,0,0,0
